TaskCode,IsByWay,AgvCode,PodCode,startTaskTime,finishTaskTime,totalCostTime,carryTimes,waitTime,deadlockTimes
3,"No", 1009,93,0,80,80,6,1,0
4,"No", 1005,118,0,95,95,6,15,1
1,"No", 1002,84,0,97,97,2,6,1
7,"No", 1006,109,0,97,97,2,7,2
6,"No", 1008,45,0,118,118,6,17,1
2,"No", 1004 1003 1001,102,0,128,128,14,14,1
5,"No", 1010,253,0,130,130,6,16,3
10,"No", 1003,26,50,132,82,2,9,2
11,"No", 1009,35,80,151,71,2,3,1
9,"No", 1001,181,36,163,127,8,11,0
12,"No", 1005,304,95,200,105,2,21,1
8,"No", 1007,49,0,233,233,6,96,3
13,"No", 1006 1002,134,97,238,141,8,11,2
16,"No", 1003,176,132,271,139,6,4,1
15,"No", 1010,280,130,275,145,2,24,7
18,"No", 1006 1001,354,163,293,130,8,21,2
17,"No", 1009,267,151,306,155,2,22,1
19,"No", 1008,358,196,315,119,2,24,1
21,"No", 1007,133,233,330,97,2,8,1
14,"No", 1008 1004,263,118,343,225,8,50,1
22,"No", 1002 1001,22,238,357,119,4,17,1
20,"No", 1005,273,200,357,157,8,13,1
24,"No", 1010,10,275,384,109,6,11,2
26,"No", 1008 1006 1009,206,293,391,98,6,3,1
25,"No", 1002,20,277,401,124,2,6,1
23,"No", 1003,310,271,421,150,2,8,0
33,"No", 1010,217,384,454,70,2,1,0
30,"No", 1001,216,357,466,109,2,2,1
29,"No", 1005,3,357,473,116,6,11,0
32,"No", 1009,284,366,482,116,2,8,2
28,"No", 1004,325,343,489,146,6,21,2
27,"No", 1007,372,330,491,161,6,37,2
35,"No", 1002,375,401,499,98,2,10,1
31,"No", 1006,354,361,516,155,2,35,0
36,"No", 1003,249,421,568,147,2,19,2
40,"No", 1004,332,489,569,80,2,0,0
41,"No", 1007 1002,248,491,571,80,4,1,0
34,"No", 1008,181,391,573,182,2,57,3
37,"No", 1010,164,454,596,142,2,18,2
42,"No", 1006,61,516,616,100,2,9,1
45,"No", 1003,236,568,626,58,2,0,0
43,"No", 1007,35,528,629,101,2,1,0
39,"No", 1009,371,482,630,148,6,26,2
38,"No", 1005 1001,78,466,642,176,8,16,1
44,"No", 1001,126,545,654,109,2,8,1
46,"No", 1004,265,569,654,85,2,7,1
47,"No", 1002,290,571,676,105,2,14,0
48,"No", 1008,351,573,697,124,2,6,0
51,"No", 1007 1009,191,629,714,85,8,11,1
53,"No", 1004,153,654,739,85,2,16,1
50,"No", 1003,190,626,740,114,2,9,0
49,"No", 1006 1010,12,596,741,145,4,9,1
52,"No", 1005,94,642,750,108,2,7,1
54,"No", 1001,307,654,760,106,2,3,1
55,"No", 1010,57,657,774,117,6,6,2
56,"No", 1002,321,676,777,101,2,11,1
59,"No", 1004 1009,208,714,807,93,4,5,1
57,"No", 1008,375,697,823,126,2,4,0
62,"No", 1005,84,750,829,79,2,2,1
58,"No", 1007,159,708,833,125,6,6,1
61,"No", 1006,296,741,843,102,2,2,1
64,"No", 1001,28,760,864,104,2,9,1
63,"No", 1009,13,756,874,118,6,3,0
65,"No", 1010,236,774,895,121,2,12,0
66,"No", 1004 1002,153,777,896,119,4,8,1
60,"No", 1003,371,740,905,165,6,33,1
67,"No", 1008,134,823,918,95,2,9,3
68,"No", 1005,137,829,931,102,2,5,1
69,"No", 1007 1002,154,833,955,122,4,31,0
74,"No", 1004,19,896,975,79,2,6,2
72,"No", 1007,218,888,977,89,2,8,2
75,"No", 1003,17,905,979,74,2,0,0
71,"No", 1009,219,874,1005,131,6,10,2
70,"No", 1006 1001,76,843,1006,163,8,17,2
73,"No", 1010,25,895,1006,111,2,17,2
77,"No", 1005,190,931,1031,100,2,7,2
78,"No", 1006,378,946,1033,87,2,2,1
79,"No", 1002,253,955,1038,83,6,14,0
84,"No", 1001,341,1006,1073,67,2,0,0
80,"No", 1004,165,975,1088,113,2,4,1
83,"No", 1010,139,1006,1099,93,2,2,0
87,"No", 1003,11,1036,1113,77,2,4,1
76,"No", 1008,125,918,1119,201,2,43,2
81,"No", 1007,246,977,1122,145,2,21,2
82,"No", 1003 1009,338,979,1134,155,4,40,0
86,"No", 1006,29,1033,1148,115,2,29,1
90,"No", 1004,289,1088,1177,89,2,1,0
85,"No", 1005,201,1031,1183,152,6,1,0
89,"No", 1001,286,1073,1195,122,2,13,0
92,"No", 1003,25,1113,1205,92,2,19,0
88,"No", 1002,177,1038,1244,206,2,37,3
93,"No", 1008 1007,105,1119,1247,128,4,23,0
91,"No", 1010,42,1099,1267,168,6,19,1
95,"No", 1008,327,1175,1271,96,2,1,0
98,"No", 1001,32,1195,1277,82,2,0,0
94,"No", 1006 1009,314,1134,1306,172,4,21,0
97,"No", 1005,360,1183,1310,127,2,9,2
96,"No", 1004 1009,3,1177,1310,133,8,17,0
99,"No", 1003,139,1205,1327,122,2,20,0
100,"No", 1004,132,1241,1333,92,2,2,0
101,"No", 1002,98,1244,1350,106,2,6,1
103,"No", 1008 1010,110,1267,1373,106,4,4,1
102,"No", 1007,377,1247,1386,139,2,10,2
105,"No", 1006 1009,379,1306,1392,86,4,0,0
104,"No", 1001 1010,58,1277,1409,132,4,2,0
108,"No", 1004,288,1333,1435,102,6,2,1
107,"No", 1003,45,1327,1436,109,2,0,0
106,"No", 1005 1001,279,1310,1449,139,3,29,4
109,"No", 1006,232,1349,1458,109,2,5,0
111,"No", 1007,142,1386,1479,93,2,9,1
112,"No", 1002 1010 1009,272,1392,1522,130,6,15,2
113,"No", 1004 1003,284,1435,1530,95,4,9,1
114,"No", 1006 1001,225,1449,1558,109,12,6,2
115,"No", 1009,289,1478,1576,98,6,13,0
110,"No", 1008 1002,82,1350,1590,240,8,29,2
116,"No", 1007,371,1479,1595,116,2,4,1
117,"No", 1005,187,1493,1614,121,6,20,1
118,"No", 1010,57,1496,1618,122,2,33,0
120,"No", 1004 1003 1001,347,1530,1658,128,10,13,1
119,"No", 1004 1002,9,1513,1670,157,4,45,2
122,"No", 1003,48,1577,1679,102,2,11,3
123,"No", 1008,47,1590,1682,92,2,10,2
126,"No", 1005,121,1614,1699,85,2,12,0
127,"No", 1006 1010,19,1618,1719,101,4,6,1
121,"No", 1006 1009,303,1558,1725,167,12,15,2
125,"No", 1001,172,1601,1737,136,6,11,2
124,"No", 1007,95,1595,1738,143,2,35,0
129,"No", 1010,99,1663,1747,84,2,1,0
128,"No", 1004,219,1658,1763,105,2,8,1
131,"No", 1008 1003,357,1679,1770,91,8,3,1
130,"No", 1002,279,1670,1774,104,2,9,1
132,"No", 1003,181,1698,1775,77,2,7,3
134,"No", 1006,21,1719,1795,76,2,5,0
133,"No", 1005,8,1699,1824,125,6,5,0
135,"No", 1009,288,1725,1833,108,2,9,3
136,"No", 1001,294,1737,1860,123,2,2,1
138,"No", 1004 1010,148,1747,1875,128,8,11,1
137,"No", 1007,89,1738,1884,146,8,22,1
139,"No", 1008 1002,189,1770,1888,118,4,2,0
142,"No", 1006,37,1795,1896,101,6,7,1
140,"No", 1003,59,1775,1902,127,2,15,0
144,"No", 1005 1009,272,1824,1912,88,4,1,0
141,"No", 1008,107,1791,1920,129,2,9,2
145,"No", 1001,357,1860,1947,87,2,2,0
143,"No", 1010,224,1797,1952,155,2,30,1
147,"No", 1004,82,1875,1967,92,2,8,1
146,"No", 1005,234,1872,1998,126,6,7,2
148,"No", 1007 1002,154,1884,2004,120,4,15,2
149,"No", 1006 1003 1009,55,1896,2021,125,5,52,3
151,"No", 1001,267,1947,2046,99,2,21,1
150,"No", 1008,255,1920,2062,142,2,14,1
154,"No", 1006,153,1970,2068,98,6,2,1
155,"No", 1005,294,1998,2090,92,2,10,0
156,"No", 1002 1009,254,2004,2104,100,4,11,0
152,"No", 1004 1010,368,1952,2113,161,14,43,1
158,"No", 1001,115,2046,2130,84,2,2,1
157,"No", 1010,32,2031,2139,108,2,5,0
161,"No", 1006,125,2068,2145,77,2,8,2
153,"No", 1007,312,1969,2155,186,8,69,2
160,"No", 1002,325,2066,2159,93,2,2,0
159,"No", 1008 1003,248,2056,2164,108,4,1,0
163,"No", 1003,30,2109,2184,75,2,5,1
162,"No", 1005 1009,15,2090,2213,123,4,23,0
164,"No", 1004,379,2113,2224,111,2,2,0
166,"No", 1007 1006 1010,192,2139,2234,95,6,22,2
168,"No", 1008,29,2164,2275,111,2,2,1
165,"No", 1005 1001,317,2130,2278,148,8,28,2
169,"No", 1003 1001 1010,14,2184,2300,116,10,20,2
167,"No", 1002,330,2159,2306,147,2,23,1
170,"No", 1004 1009,320,2213,2313,100,8,8,0
171,"No", 1006,42,2224,2328,104,2,4,1
173,"No", 1003,247,2246,2342,96,2,7,1
175,"No", 1005,208,2278,2365,87,2,3,1
174,"No", 1008 1010,356,2273,2373,100,8,17,2
172,"No", 1007,64,2234,2375,141,8,4,0
176,"No", 1001 1009,161,2290,2394,104,8,8,1
177,"No", 1004 1002,372,2306,2407,101,4,6,1
178,"No", 1006,324,2328,2415,87,2,2,1
179,"No", 1003 1009,146,2335,2456,121,4,21,0
180,"No", 1010,316,2355,2456,101,6,5,2
181,"No", 1005,114,2365,2463,98,2,0,0
184,"No", 1009,200,2401,2488,87,2,2,1
187,"No", 1006,126,2415,2510,95,2,12,1
185,"No", 1004,296,2407,2517,110,2,13,0
186,"No", 1002,205,2414,2532,118,2,5,1
182,"No", 1008 1007,202,2373,2566,193,8,60,1
183,"No", 1002 1001,330,2375,2572,197,8,32,1
189,"No", 1005 1010,65,2456,2574,118,4,14,0
190,"No", 1008,89,2484,2584,100,2,13,1
188,"No", 1008 1003,214,2440,2585,145,4,16,3
191,"No", 1009,181,2488,2616,128,6,25,2
192,"No", 1006 1004,258,2510,2617,107,4,22,1
194,"No", 1002,271,2532,2637,105,2,2,0
198,"No", 1008,293,2584,2661,77,2,2,1
196,"No", 1007,218,2566,2672,106,2,1,0
199,"No", 1003 1009,30,2585,2693,108,3,46,3
197,"No", 1005 1001,368,2572,2705,133,4,39,6
200,"No", 1004,114,2617,2709,92,2,5,0
193,"No", 1010,274,2518,2736,218,6,41,4
202,"No", 1008,299,2661,2737,76,2,0,0
204,"No", 1007 1009,365,2672,2767,95,4,3,0
203,"No", 1001,222,2667,2775,108,6,2,1
201,"No", 1002,304,2637,2778,141,2,18,3
205,"No", 1007 1005 1004,323,2705,2793,88,5,48,2
207,"No", 1008 1003,123,2737,2828,91,4,6,2
206,"No", 1010,248,2736,2838,102,6,11,0
209,"No", 1005,80,2776,2846,70,2,0,0
208,"No", 1001 1009,207,2767,2856,89,8,11,0
195,"No", 1006,174,2552,2872,320,6,59,4
210,"No", 1002,349,2778,2890,112,6,2,0
211,"No", 1008 1007,297,2793,2897,104,4,0,0
213,"No", 1003 1010,226,2828,2942,114,4,6,2
217,"No", 1006,13,2872,2947,75,2,0,0
212,"No", 1004,299,2820,2965,145,6,12,2
214,"No", 1005,252,2846,2989,143,2,5,1
216,"No", 1007,188,2859,2992,133,2,7,3
215,"No", 1001 1009,285,2850,3005,155,10,33,1
219,"No", 1009,197,2920,3012,92,2,17,1
218,"No", 1008 1003 1002,2,2890,3015,125,6,42,2
220,"No", 1006 1010,350,2942,3057,115,12,0,0
221,"No", 1004 1002,94,2965,3074,109,4,2,0
224,"No", 1008 1004 1003,284,3015,3101,86,4,62,4
222,"No", 1007 1005 1003,216,2980,3125,145,10,49,4
223,"No", 1001 1010 1009,96,3005,3152,147,6,67,11
229,"No", 1007,99,3125,3202,77,2,2,1
225,"No", 1006 1002,327,3057,3207,150,8,25,2
226,"No", 1001,198,3086,3209,123,6,12,3
227,"No", 1003,340,3101,3225,124,2,17,1
233,"No", 1010,244,3152,3248,96,2,9,0
230,"No", 1009,133,3132,3250,118,6,1,0
234,"No", 1004,218,3162,3255,93,2,5,1
232,"No", 1006,227,3140,3258,118,2,4,1
228,"No", 1008,22,3122,3264,142,2,27,0
231,"No", 1005,321,3137,3281,144,2,28,1
235,"No", 1007 1002,81,3202,3285,83,4,2,0
236,"No", 1003 1001,268,3209,3339,130,4,3,0
239,"No", 1009,378,3250,3344,94,2,1,0
237,"No", 1010,31,3248,3344,96,2,4,2
240,"No", 1007 1004,279,3253,3375,122,4,34,4
238,"No", 1001,252,3248,3388,140,6,8,0
241,"No", 1008 1006 1005,80,3258,3407,149,10,39,2
243,"No", 1007 1003,140,3339,3427,88,6,25,1
245,"No", 1010,241,3344,3432,88,2,3,0
242,"No", 1002,111,3285,3450,165,2,31,1
246,"No", 1006,344,3361,3452,91,2,5,0
247,"No", 1004,10,3375,3468,93,2,18,1
244,"No", 1009,293,3344,3480,136,6,17,2
248,"No", 1008 1001,77,3382,3492,110,12,16,1
249,"No", 1007 1005,328,3407,3516,109,4,0,0
250,"No", 1010,190,3432,3531,99,2,3,1
253,"No", 1006,20,3452,3560,108,2,5,0
251,"No", 1003,26,3447,3574,127,2,5,1
252,"No", 1005 1002,166,3450,3598,148,12,18,1
254,"No", 1004 1009,348,3468,3614,146,4,14,1
255,"No", 1008,302,3487,3618,131,2,8,3
256,"No", 1001,220,3492,3620,128,2,19,1
259,"No", 1007,294,3559,3642,83,2,1,0
258,"No", 1002,94,3545,3653,108,2,2,1
257,"No", 1007 1004 1010,238,3516,3666,150,10,5,0
262,"No", 1004,20,3586,3671,85,2,3,0
260,"No", 1006,139,3560,3685,125,14,4,1
263,"No", 1005 1009,121,3598,3707,109,4,6,3
261,"No", 1003,315,3574,3713,139,2,12,0
266,"No", 1005,222,3645,3716,71,2,2,0
265,"No", 1007,39,3642,3748,106,2,4,0
267,"No", 1008 1002,358,3651,3764,113,8,22,3
268,"No", 1010,365,3666,3764,98,2,6,2
264,"No", 1008 1001,192,3618,3774,156,4,40,4
269,"No", 1004,94,3671,3812,141,8,16,1
273,"No", 1008,142,3737,3814,77,2,0,0
272,"No", 1005,338,3716,3816,100,2,11,0
271,"No", 1003,279,3713,3839,126,6,4,0
277,"No", 1001,214,3774,3852,78,2,0,0
270,"No", 1006 1009,237,3685,3863,178,8,28,0
276,"No", 1002 1010,70,3764,3872,108,4,18,0
274,"No", 1007,224,3748,3881,133,2,33,1
275,"No", 1006,209,3762,3897,135,2,6,2
279,"No", 1002,24,3813,3898,85,2,5,0
280,"No", 1008,121,3814,3903,89,2,4,1
278,"No", 1004,202,3812,3912,100,2,0,0
281,"No", 1005 1003,269,3816,3920,104,4,4,1
283,"No", 1001,61,3852,3939,87,2,6,2
282,"No", 1005,218,3848,3957,109,2,8,0
286,"No", 1007 1006,186,3881,3961,80,4,2,0
287,"No", 1002,153,3898,3967,69,2,0,0
284,"No", 1009,211,3863,4001,138,6,15,2
285,"No", 1010,204,3872,4013,141,2,18,1
291,"No", 1008 1001,45,3939,4023,84,4,0,0
288,"No", 1008 1004,281,3903,4037,134,8,9,0
290,"No", 1007,194,3933,4041,108,2,9,0
292,"No", 1005,252,3957,4091,134,2,52,2
294,"No", 1009,20,4001,4108,107,2,18,2
289,"No", 1003,356,3920,4135,215,8,35,2
298,"No", 1006,166,4040,4136,96,6,2,1
299,"No", 1007,130,4041,4138,97,2,6,0
293,"No", 1006 1002 1001,300,3961,4162,201,6,70,4
296,"No", 1008,76,4023,4165,142,2,44,3
301,"No", 1005 1009,30,4091,4178,87,4,22,2
295,"No", 1010,192,4013,4182,169,6,38,5
300,"No", 1002,225,4072,4191,119,2,18,0
304,"No", 1007,59,4138,4233,95,2,2,0
297,"No", 1004,341,4037,4235,198,8,34,1
303,"No", 1006,9,4136,4241,105,2,7,0
302,"No", 1003,228,4135,4248,113,2,9,4
306,"No", 1008 1001 1009,44,4162,4264,102,6,42,1
305,"No", 1005,26,4157,4271,114,6,24,1
308,"No", 1002,121,4191,4281,90,6,5,1
307,"No", 1010,209,4182,4296,114,2,31,2
309,"No", 1001,181,4195,4305,110,6,9,1
312,"No", 1003,93,4248,4335,87,2,6,0
314,"No", 1005,245,4271,4354,83,2,16,0
311,"No", 1008 1006,27,4241,4355,114,4,5,0
310,"No", 1007 1004,86,4233,4367,134,8,27,1
315,"No", 1006,58,4278,4382,104,2,5,1
318,"No", 1007 1001,199,4305,4418,113,4,18,1
319,"No", 1003,16,4335,4433,98,2,18,3
313,"No", 1009,17,4264,4437,173,6,41,5
320,"No", 1008 1005,340,4354,4448,94,4,1,0
322,"No", 1001,360,4371,4481,110,2,1,0
324,"No", 1007 1005,145,4413,4501,88,4,0,0
321,"No", 1004,68,4367,4506,139,2,34,3
323,"No", 1006,166,4382,4520,138,2,29,3
316,"No", 1002,374,4281,4522,241,6,64,3
325,"No", 1003,345,4433,4539,106,6,18,0
317,"No", 1010,110,4296,4539,243,2,82,5
327,"No", 1005,157,4467,4582,115,2,2,1
328,"No", 1001,377,4481,4609,128,2,28,3
326,"No", 1008 1009,8,4437,4610,173,8,40,3
329,"No", 1007,93,4501,4612,111,2,24,4
332,"No", 1009,36,4539,4620,81,2,2,1
331,"No", 1002,179,4522,4624,102,2,0,0
333,"No", 1003,283,4539,4640,101,2,13,1
330,"No", 1006 1004,96,4506,4648,142,4,29,2
335,"No", 1004,16,4575,4673,98,2,11,3
334,"No", 1010,90,4539,4719,180,2,16,4
337,"No", 1001 1009,82,4615,4724,109,4,27,1
340,"No", 1008 1003,251,4648,4744,96,8,4,1
338,"No", 1005 1003 1002,342,4624,4746,122,6,18,2
339,"No", 1006,86,4648,4748,100,2,18,2
336,"No", 1008 1007 1005,11,4582,4760,178,10,38,3
341,"No", 1004,198,4673,4794,121,8,0,0
346,"No", 1006 1005,33,4746,4840,94,4,2,0
343,"No", 1008 1002,104,4729,4858,129,10,6,2
345,"No", 1001,81,4744,4865,121,2,28,1
344,"No", 1003,100,4744,4867,123,2,17,0
342,"No", 1001 1010 1009,160,4682,4869,187,6,71,2
348,"No", 1004,362,4794,4885,91,2,5,2
349,"No", 1010,286,4798,4898,100,2,8,3
350,"No", 1005,112,4798,4915,117,4,9,0
352,"No", 1006,214,4840,4932,92,2,9,0
347,"No", 1007,192,4760,4951,191,6,38,2
354,"No", 1001,148,4865,4961,96,2,6,1
353,"No", 1008,174,4858,4978,120,6,19,0
351,"No", 1002,47,4836,4983,147,8,14,1
355,"No", 1003 1009,162,4867,4984,117,4,11,1
358,"No", 1003,263,4930,5005,75,2,1,0
356,"No", 1004,244,4885,5016,131,8,2,1
357,"No", 1005 1010,343,4898,5019,121,4,0,0
360,"No", 1007,41,4951,5050,99,2,4,2
359,"No", 1006,80,4932,5056,124,6,3,1
363,"No", 1002,111,4983,5057,74,2,1,0
361,"No", 1010,220,4956,5074,118,2,34,1
364,"No", 1009,268,4984,5079,95,2,8,0
365,"No", 1003,126,5005,5110,105,2,3,0
362,"No", 1008 1001,117,4961,5119,158,4,16,1
367,"No", 1005,262,5019,5123,104,6,4,0
369,"No", 1002,149,5057,5144,87,2,2,1
371,"No", 1009,281,5079,5152,73,2,2,0
368,"No", 1007 1006,110,5050,5183,133,4,31,1
370,"No", 1010,198,5074,5192,118,2,5,0
374,"No", 1008,115,5119,5202,83,2,12,2
375,"No", 1007,190,5123,5206,83,6,10,2
372,"No", 1001,37,5109,5213,104,2,17,0
376,"No", 1005 1002 1009,212,5123,5217,94,6,9,0
366,"No", 1004 1001,148,5014,5226,212,12,46,4
373,"No", 1003,357,5110,5229,119,6,17,1
380,"No", 1008,244,5202,5274,72,2,7,2
377,"No", 1006 1005,252,5183,5282,99,4,14,0
378,"No", 1002,372,5186,5297,111,6,4,1
384,"No", 1006,94,5231,5327,96,2,2,1
382,"No", 1004 1009,33,5217,5329,112,4,19,2
383,"No", 1003,28,5229,5342,113,2,4,0
381,"No", 1007 1001,59,5206,5344,138,10,18,1
385,"No", 1007,273,5259,5376,117,6,11,1
386,"No", 1008 1005,172,5274,5382,108,8,7,0
389,"No", 1008 1004,84,5329,5409,80,3,18,3
379,"No", 1010,83,5192,5409,217,10,23,2
387,"No", 1009,220,5286,5417,131,2,27,0
390,"No", 1003,64,5342,5446,104,2,14,1
391,"No", 1002 1001,286,5344,5464,120,4,23,0
392,"No", 1007,304,5376,5477,101,2,4,1
388,"No", 1006 1002,41,5297,5485,188,4,10,1
396,"No", 1009,94,5417,5485,68,2,2,0
395,"No", 1001,37,5415,5502,87,2,0,0
393,"No", 1005 1010,62,5382,5515,133,8,4,0
397,"No", 1004,102,5417,5519,102,2,4,1
398,"No", 1003,72,5446,5547,101,2,15,4
400,"No", 1007 1005,323,5468,5547,79,4,20,0
399,"No", 1005 1002,95,5448,5549,101,4,6,2
402,"No", 1001 1009,119,5485,5577,92,4,5,1
401,"No", 1006,192,5485,5613,128,6,6,1
404,"No", 1009,31,5545,5628,83,2,0,0
394,"No", 1008,350,5409,5633,224,6,22,0
407,"No", 1002 1001,140,5549,5656,107,4,1,0
405,"No", 1007,135,5547,5657,110,2,0,0
403,"No", 1005 1004 1010,365,5515,5660,145,10,39,3
408,"No", 1004 1002,370,5590,5687,97,3,23,3
406,"No", 1003,215,5547,5688,141,2,29,1
409,"No", 1010,181,5608,5712,104,6,0,0
410,"No", 1006,233,5613,5739,126,2,0,0
412,"No", 1001,6,5656,5742,86,2,5,1
411,"No", 1008 1009,302,5628,5745,117,6,9,2
414,"No", 1005,4,5660,5764,104,6,5,0
415,"No", 1008,310,5667,5787,120,2,3,1
413,"No", 1007,292,5657,5792,135,6,15,0
416,"No", 1003 1002 1010,48,5687,5805,118,12,7,1
417,"No", 1004 1002,351,5719,5817,98,4,1,1
420,"No", 1005,137,5764,5848,84,2,3,0
424,"No", 1010,362,5805,5868,63,2,6,0
419,"No", 1003,94,5757,5869,112,2,2,0
418,"No", 1006 1001 1009,141,5739,5869,130,6,78,0
425,"No", 1006 1002,119,5817,5899,82,4,3,0
423,"No", 1007,249,5792,5900,108,2,4,0
421,"No", 1004,105,5776,5909,133,2,7,2
422,"No", 1008,152,5787,5924,137,2,20,0
426,"No", 1005 1001,164,5827,5932,105,4,1,0
427,"No", 1002,198,5863,5942,79,2,4,1
431,"No", 1007 1004,219,5900,6014,114,4,18,1
434,"No", 1007,327,5945,6025,80,2,0,0
428,"No", 1010 1009,286,5868,6043,175,8,107,2
433,"No", 1005 1003 1002,341,5932,6063,131,6,16,0
429,"No", 1003 1001,370,5869,6069,200,8,94,1
435,"No", 1005 1003,125,5977,6095,118,8,20,3
432,"No", 1008,357,5924,6099,175,2,58,2
436,"No", 1010,221,6001,6124,123,2,34,2
438,"No", 1004,110,6014,6130,116,2,43,3
441,"No", 1002 1001,109,6063,6131,68,4,2,0
439,"No", 1007,252,6025,6153,128,2,5,1
440,"No", 1009,153,6043,6158,115,6,42,1
437,"No", 1005,175,6010,6175,165,2,41,2
430,"No", 1006,37,5899,6188,289,6,151,1
443,"No", 1008,96,6099,6215,116,2,0,0
444,"No", 1002 1010,2,6124,6243,119,8,2,0
445,"No", 1007 1004 1001,120,6130,6243,113,10,14,3
447,"No", 1010,306,6171,6252,81,6,0,0
442,"No", 1003,113,6095,6265,170,2,22,2
448,"No", 1004,193,6174,6295,121,6,3,1
446,"No", 1009,181,6158,6295,137,10,2,1
452,"No", 1002,279,6243,6308,65,2,3,1
451,"No", 1005,163,6242,6313,71,2,0,0
455,"No", 1008,78,6271,6349,78,2,8,1
450,"No", 1008 1001,349,6215,6351,136,4,47,0
449,"No", 1006 1005,379,6175,6363,188,8,35,3
453,"No", 1007 1010,98,6243,6372,129,4,36,3
458,"No", 1004 1002,60,6295,6383,88,4,3,0
456,"No", 1007,11,6286,6399,113,2,4,1
459,"No", 1005,99,6313,6413,100,8,0,0
457,"No", 1009,61,6295,6439,144,2,44,3
454,"No", 1003,203,6265,6443,178,2,42,5
464,"No", 1002,80,6383,6476,93,2,12,0
462,"No", 1006,280,6363,6484,121,2,37,1
463,"No", 1010,102,6372,6495,123,6,12,1
467,"No", 1009,41,6439,6516,77,2,12,3
465,"No", 1007,87,6399,6522,123,2,12,2
466,"No", 1008 1005,372,6413,6535,122,4,40,4
460,"No", 1008 1001,188,6349,6536,187,4,60,3
461,"No", 1004,141,6353,6561,208,6,34,4
468,"No", 1003 1002,28,6443,6563,120,8,14,1
470,"No", 1010 1009,79,6495,6583,88,4,2,1
469,"No", 1006,189,6484,6596,112,2,8,1
472,"No", 1003,297,6530,6618,88,2,0,0
471,"No", 1007 1005 1010,197,6517,6637,120,6,66,2
473,"No", 1008 1004 1001,118,6535,6661,126,10,10,1
474,"No", 1008 1002,368,6563,6667,104,4,4,2
480,"No", 1006,87,6623,6680,57,2,4,0
479,"No", 1007,199,6623,6696,73,2,1,0
476,"No", 1001,179,6600,6707,107,2,11,0
478,"No", 1005,292,6621,6723,102,2,3,0
475,"No", 1006 1002 1009,53,6583,6731,148,6,23,1
483,"No", 1008,351,6667,6732,65,2,8,2
477,"No", 1003 1009,242,6610,6752,142,4,43,2
481,"No", 1010,348,6637,6752,115,8,2,1
484,"No", 1006,30,6680,6754,74,2,5,1
482,"No", 1004,201,6661,6763,102,2,22,0
485,"No", 1009,349,6692,6777,85,2,0,0
486,"No", 1007,368,6696,6795,99,6,5,1
489,"No", 1002,117,6731,6813,82,2,3,1
492,"No", 1006 1010,219,6752,6821,69,4,1,0
491,"No", 1003,367,6752,6840,88,2,0,0
488,"No", 1005,20,6723,6848,125,2,24,1
487,"No", 1001,134,6707,6855,148,2,53,3
493,"No", 1004,118,6763,6895,132,2,25,2
490,"No", 1008,230,6732,6903,171,2,47,5
495,"No", 1007 1002,329,6795,6911,116,4,2,0
496,"No", 1010,251,6815,6927,112,2,0,0
494,"No", 1009,17,6777,6928,151,2,51,4
498,"No", 1007,109,6853,6950,97,2,7,1
499,"No", 1001,26,6855,6951,96,2,4,2
500,"No", 1006,216,6894,6968,74,2,4,0
497,"No", 1006 1005 1003,87,6821,6981,160,10,11,1
501,"No", 1004,314,6895,7019,124,2,21,1
502,"No", 1008 1003 1002,3,6903,7038,135,6,5,0
507,"No", 1007,199,6950,7073,123,2,26,2
510,"No", 1005,140,6981,7074,93,2,25,1
511,"No", 1004,80,7019,7094,75,2,0,0
504,"No", 1009,85,6928,7109,181,6,54,5
508,"No", 1001,350,6951,7135,184,2,49,5
503,"No", 1010,211,6927,7137,210,6,94,2
505,"No", 1008,238,6937,7139,202,6,63,6
512,"No", 1002,84,7038,7151,113,2,15,0
506,"No", 1003,62,6944,7154,210,2,89,6
509,"No", 1006,175,6968,7155,187,2,46,1
513,"No", 1007 1005,289,7073,7188,115,4,6,2
514,"No", 1007 1004,164,7094,7197,103,4,3,1
515,"No", 1009,80,7109,7215,106,6,10,0
516,"No", 1004,12,7134,7243,109,2,5,0
517,"No", 1001,227,7135,7244,109,2,0,0
518,"No", 1008 1010,338,7137,7274,137,8,10,2
522,"No", 1007 1005,303,7188,7288,100,4,5,0
520,"No", 1006 1003,291,7154,7294,140,4,35,2
524,"No", 1009,24,7215,7309,94,2,0,0
521,"No", 1010,41,7186,7317,131,6,12,0
519,"No", 1002,167,7151,7323,172,2,20,0
523,"No", 1003,215,7211,7336,125,2,17,1
526,"No", 1008 1004 1001,206,7243,7343,100,10,0,0
525,"No", 1005,348,7221,7346,125,2,22,1
527,"No", 1007,217,7288,7383,95,2,3,1
528,"No", 1006,332,7294,7399,105,2,3,0
529,"No", 1004,228,7296,7412,116,2,8,1
530,"No", 1009,338,7309,7424,115,8,3,0
535,"No", 1005,293,7346,7436,90,2,4,1
532,"No", 1003 1002,31,7323,7453,130,4,1,0
540,"No", 1005,300,7436,7514,78,2,5,0
541,"No", 1006 1003,358,7453,7545,92,4,2,0
543,"No", 1003,140,7516,7605,89,2,10,2
542,"No", 1005,202,7514,7612,98,2,16,3
539,"No", 1009,174,7424,7642,218,2,91,6
545,"No", 1003,43,7605,7667,62,2,0,0
546,"No", 1005,165,7612,7699,87,2,0,0
531,"No", 1001 1010,29,7316,7715,399,8,139,6
549,"No", 1005 1010,377,7699,7805,106,4,13,0
533,"No", 1002,273,7339,7905,566,6,194,15
548,"No", 1003,191,7667,7917,250,2,79,3
550,"No", 1005 1010,154,7772,7928,156,4,20,1
534,"No", 1008,192,7343,7932,589,6,223,17
544,"No", 1006,274,7545,7936,391,2,147,12
551,"No", 1005 1002,55,7824,7984,160,4,21,1
536,"No", 1001,65,7376,7993,617,2,241,14
547,"No", 1009,177,7642,8000,358,2,142,7
537,"No", 1007,268,7383,8002,619,2,279,20
553,"No", 1003,161,7917,8033,116,6,17,0
552,"No", 1005,135,7911,8040,129,2,6,0
538,"No", 1006 1004,35,7399,8041,642,4,269,10
555,"No", 1008 1006,290,7932,8063,131,8,5,1
554,"No", 1010,33,7928,8072,144,6,27,1
556,"No", 1002,96,7984,8081,97,2,7,1
559,"No", 1007 1009,251,8000,8092,92,4,8,1
558,"No", 1001,321,7993,8098,105,2,12,0
564,"No", 1010,42,8072,8155,83,2,5,0
557,"No", 1008,66,7984,8161,177,6,4,0
560,"No", 1003,121,8033,8167,134,2,12,0
561,"No", 1005 1004,227,8040,8172,132,4,33,1
565,"No", 1002,274,8081,8174,93,2,8,2
562,"No", 1009,20,8062,8179,117,2,23,2
567,"No", 1005,9,8127,8191,64,2,2,0
566,"No", 1007 1001,135,8092,8194,102,4,13,0
563,"No", 1006,219,8063,8210,147,6,4,1
572,"No", 1009,26,8179,8253,74,2,4,1
569,"No", 1008 1007,241,8155,8260,105,4,26,1
568,"No", 1010,362,8155,8275,120,2,28,0
570,"No", 1004 1003,160,8167,8279,112,8,15,2
574,"No", 1001,72,8194,8280,86,2,10,2
573,"No", 1005,59,8191,8284,93,2,4,2
575,"No", 1006,232,8210,8288,78,2,2,0
571,"No", 1002,199,8174,8301,127,2,19,1
577,"No", 1009,177,8253,8339,86,2,8,3
576,"No", 1007,33,8234,8357,123,6,14,0
578,"No", 1008,8,8260,8371,111,6,5,1
579,"No", 1003,211,8263,8384,121,2,28,2
584,"No", 1006,238,8288,8406,118,2,43,2
583,"No", 1005,146,8284,8414,130,2,18,1
581,"No", 1004,96,8279,8419,140,2,33,2
586,"No", 1009,64,8339,8437,98,2,11,0
585,"No", 1002,205,8301,8439,138,2,21,1
580,"No", 1010,50,8275,8440,165,2,46,3
588,"No", 1008,291,8371,8476,105,2,0,0
582,"No", 1001,283,8280,8496,216,2,63,4
590,"No", 1006,25,8406,8498,92,2,4,1
587,"No", 1007,325,8357,8507,150,2,20,1
591,"No", 1005,255,8414,8542,128,6,6,1
589,"No", 1003,198,8384,8547,163,2,17,1
592,"No", 1004,8,8419,8574,155,2,9,1
597,"No", 1007,360,8507,8580,73,2,3,1
593,"No", 1002 1009,15,8437,8593,156,4,51,2
595,"No", 1010,86,8480,8594,114,2,9,0
598,"No", 1009,104,8510,8603,93,2,3,0
594,"No", 1008 1010,145,8440,8612,172,4,13,1
600,"No", 1003,32,8547,8622,75,2,4,1
596,"No", 1006 1001,217,8496,8631,135,4,46,0
599,"No", 1005,203,8542,8647,105,2,2,1
601,"No", 1001,83,8567,8684,117,2,13,2
602,"No", 1004,344,8574,8688,114,2,8,1
605,"No", 1008 1009,244,8603,8708,105,4,2,1
606,"No", 1003,342,8622,8713,91,2,16,1
604,"No", 1010,141,8594,8722,128,2,16,0
608,"No", 1007,370,8645,8738,93,6,14,0
603,"No", 1007 1002,71,8580,8772,192,4,26,3
609,"No", 1005,235,8647,8772,125,2,15,1
607,"No", 1006,201,8631,8778,147,2,17,0
611,"No", 1004,299,8688,8808,120,6,18,1
613,"No", 1010 1009,273,8718,8812,94,8,1,0
610,"No", 1001 1009,51,8661,8834,173,4,13,2
614,"No", 1008 1007,371,8738,8843,105,4,7,2
612,"No", 1008 1003,284,8708,8858,150,4,18,1
615,"No", 1002,255,8772,8869,97,2,1,0
618,"No", 1007,221,8793,8899,106,6,4,0
617,"No", 1006,91,8778,8901,123,6,10,1
619,"No", 1004 1009,193,8795,8912,117,4,14,1
616,"No", 1005,175,8772,8912,140,6,15,1
620,"No", 1001 1010 1009,347,8812,8939,127,6,25,1
621,"No", 1008 1003,252,8843,8963,120,4,6,2
626,"No", 1006,125,8907,8969,62,2,4,1
622,"No", 1002,19,8869,8990,121,6,19,0
623,"No", 1010,216,8878,8993,115,2,24,1
627,"No", 1005 1004,72,8912,9011,99,4,8,1
624,"No", 1007,11,8899,9029,130,6,19,1
630,"No", 1001,299,8939,9042,103,2,10,0
629,"No", 1004,21,8939,9046,107,2,19,0
633,"No", 1010,357,8993,9061,68,2,0,0
628,"No", 1008,160,8914,9063,149,6,30,3
632,"No", 1002,19,8990,9070,80,2,3,0
631,"No", 1006 1003,288,8963,9086,123,8,23,1
634,"No", 1005,209,9011,9090,79,2,13,0
635,"No", 1003,86,9017,9121,104,2,4,2
625,"No", 1009,29,8903,9128,225,10,12,3
637,"No", 1001,81,9042,9182,140,2,25,2
638,"No", 1004 1010,139,9046,9187,141,4,12,1
641,"No", 1005,284,9090,9189,99,2,6,3
636,"No", 1007,285,9029,9202,173,6,20,1
640,"No", 1006,211,9086,9215,129,2,28,2
639,"No", 1008 1002,110,9063,9218,155,4,20,1
642,"No", 1004,379,9109,9231,122,2,19,2
644,"No", 1008 1009,83,9127,9238,111,4,1,0
647,"No", 1008,370,9189,9262,73,2,8,2
643,"No", 1003,124,9121,9269,148,6,10,0
645,"No", 1001,288,9182,9297,115,2,16,1
648,"No", 1007 1005,241,9189,9308,119,4,11,4
651,"No", 1008,350,9262,9325,63,2,0,0
646,"No", 1010,269,9187,9333,146,6,16,1
649,"No", 1006 1004 1002,267,9215,9351,136,6,25,2
653,"No", 1006 1002,80,9290,9366,76,4,3,0
650,"No", 1009,304,9238,9370,132,2,10,2
652,"No", 1005 1003,57,9269,9395,126,14,36,1
658,"No", 1004,27,9351,9423,72,2,2,0
654,"No", 1001,135,9297,9424,127,2,22,2
655,"No", 1007,209,9308,9428,120,2,8,1
661,"No", 1008,177,9381,9458,77,2,13,3
662,"No", 1005,57,9395,9477,82,2,21,4
660,"No", 1009,98,9370,9477,107,2,6,2
656,"No", 1008 1010,341,9325,9500,175,8,31,3
664,"No", 1004,338,9423,9530,107,2,14,2
659,"No", 1003 1002,140,9366,9548,182,4,25,0
657,"No", 1006,141,9338,9557,219,2,19,1
665,"No", 1007 1001,231,9424,9557,133,4,29,1
666,"No", 1008 1005 1009,77,9458,9586,128,10,25,4
663,"No", 1003,181,9398,9604,206,6,48,4
667,"No", 1010,279,9500,9626,126,2,15,0
668,"No", 1001,219,9508,9630,122,2,3,0
671,"No", 1006,205,9557,9662,105,2,10,1
670,"No", 1007 1002,247,9548,9664,116,12,12,2
669,"No", 1008 1005 1004,39,9530,9679,149,10,69,2
673,"No", 1003,208,9604,9685,81,2,1,0
672,"No", 1009,329,9586,9702,116,2,9,1
674,"No", 1008 1010,95,9615,9727,112,8,5,0
675,"No", 1001,321,9630,9728,98,2,6,3
676,"No", 1004 1002,6,9648,9733,85,8,20,0
679,"No", 1003 1009,200,9685,9786,101,8,3,1
680,"No", 1006,44,9709,9797,88,2,5,1
677,"No", 1007 1006,167,9662,9797,135,4,10,2
678,"No", 1005,13,9679,9814,135,2,5,1
682,"No", 1004 1010,118,9723,9836,113,8,0,0
681,"No", 1008,182,9714,9848,134,2,4,1
684,"No", 1003,121,9754,9860,106,2,3,1
683,"No", 1002 1001,139,9728,9867,139,4,12,0
685,"No", 1004,191,9755,9880,125,2,18,0
686,"No", 1001,207,9767,9881,114,2,4,1
687,"No", 1009,43,9786,9921,135,2,38,3
688,"No", 1007 1006,89,9797,9937,140,4,2,0
689,"No", 1005 1010,271,9814,9952,138,4,16,0
690,"No", 1008,44,9848,9969,121,2,11,2
694,"No", 1005,221,9891,9991,100,2,4,1
691,"No", 1007 1003,114,9857,10007,150,4,44,4
698,"No", 1010,190,9952,10030,78,2,6,1
693,"No", 1001,315,9881,10033,152,6,31,3
696,"No", 1007,26,9918,10040,122,6,7,1
699,"No", 1008 1009,79,9963,10063,100,3,41,4
700,"No", 1005,191,9991,10104,113,2,10,1
697,"No", 1006 1009,135,9921,10108,187,4,38,5
702,"No", 1010,20,10030,10114,84,2,3,0
692,"No", 1004 1002,253,9867,10117,250,4,65,5
695,"No", 1002,336,9917,10130,213,2,53,7
704,"No", 1008 1007,286,10040,10141,101,4,4,0
703,"No", 1001,123,10033,10152,119,2,6,1
705,"No", 1007 1005 1009,100,10067,10160,93,6,10,1
706,"No", 1006,140,10108,10197,89,6,0,0
708,"No", 1008 1002,226,10130,10214,84,4,8,1
709,"No", 1007,212,10148,10216,68,2,2,1
707,"No", 1004 1010,142,10114,10219,105,4,20,0
701,"No", 1003,192,10007,10244,237,2,46,5
711,"No", 1005 1001,78,10152,10263,111,4,12,1
710,"No", 1009,242,10152,10301,149,6,32,2
712,"No", 1010,20,10175,10306,131,2,9,0
713,"No", 1006 1002,61,10197,10315,118,10,3,0
714,"No", 1001,107,10206,10323,117,2,7,2
715,"No", 1008 1007,127,10214,10329,115,4,9,1
717,"No", 1003,89,10244,10336,92,2,10,1
718,"No", 1008 1006 1005,76,10263,10377,114,6,8,2
716,"No", 1004,331,10219,10397,178,2,4,0
719,"No", 1009,222,10301,10406,105,2,2,0
720,"No", 1002 1010,113,10306,10423,117,4,2,0
724,"No", 1008 1006,255,10377,10446,69,3,25,1
723,"No", 1008 1007,188,10345,10476,131,8,16,3
722,"No", 1007 1003 1010,265,10329,10486,157,12,40,2
721,"No", 1005 1001,55,10323,10505,182,8,33,3
729,"No", 1008,21,10446,10527,81,2,7,2
726,"No", 1001,280,10407,10557,150,2,19,1
731,"No", 1004,115,10478,10570,92,2,4,1
730,"No", 1007,12,10476,10581,105,2,22,2
728,"No", 1003,348,10439,10582,143,6,14,2
732,"No", 1010,307,10486,10600,114,2,18,1
727,"No", 1002,165,10423,10601,178,2,29,3
734,"No", 1005,207,10505,10615,110,2,13,0
733,"No", 1006,119,10498,10622,124,2,25,0
725,"No", 1004 1009,360,10397,10628,231,8,50,8
735,"No", 1008 1001,378,10527,10634,107,8,4,1
737,"No", 1003,162,10582,10663,81,2,4,1
738,"No", 1008,78,10590,10693,103,2,0,0
740,"No", 1005 1002,299,10601,10698,97,4,0,0
739,"No", 1010,357,10600,10698,98,2,12,0
742,"No", 1004,22,10640,10740,100,2,5,1
743,"No", 1003 1002,10,10647,10750,103,4,0,0
736,"No", 1007 1004,93,10570,10771,201,12,18,0
744,"No", 1002,192,10675,10780,105,2,1,0
746,"No", 1005,368,10698,10797,99,6,5,0
749,"No", 1003 1009,105,10750,10819,69,4,0,0
741,"No", 1006 1001 1009,142,10622,10857,235,14,142,11
753,"No", 1003,3,10799,10894,95,2,3,1
747,"No", 1010,299,10698,10895,197,2,55,4
751,"No", 1007,84,10771,10905,134,6,5,1
748,"No", 1004,328,10740,10908,168,2,50,5
750,"No", 1006,59,10762,10912,150,2,32,4
745,"No", 1008,225,10693,10915,222,2,44,2
752,"No", 1005 1002,324,10780,10918,138,4,12,0
756,"No", 1002,162,10865,10957,92,2,4,1
755,"No", 1001,294,10857,10968,111,2,11,3
759,"No", 1006,350,10912,10976,64,2,2,0
754,"No", 1002 1009,258,10806,10999,193,8,13,1
757,"No", 1007 1003 1010,237,10894,11016,122,10,25,2
766,"No", 1009,212,10999,11063,64,2,9,2
761,"No", 1005,127,10918,11064,146,2,2,0
760,"No", 1008,177,10915,11066,151,6,6,0
758,"No", 1004,55,10908,11069,161,2,17,0
763,"No", 1003 1010,160,10961,11080,119,8,19,1
765,"No", 1001,296,10993,11097,104,2,15,1
762,"No", 1002,215,10957,11103,146,2,36,2
771,"No", 1010,225,11080,11164,84,2,5,1
773,"No", 1001,51,11097,11176,79,2,0,0
764,"No", 1006 1001,336,10968,11180,212,4,48,3
767,"No", 1007 1003,303,11016,11186,170,8,38,3
770,"No", 1008 1004,130,11066,11191,125,4,27,4
768,"No", 1009,286,11063,11195,132,2,28,3
772,"No", 1007,64,11084,11207,123,2,29,2
769,"No", 1005,350,11064,11229,165,2,44,2
776,"No", 1001 1010,126,11164,11258,94,4,3,1
775,"No", 1008,116,11148,11267,119,2,6,0
777,"No", 1006,271,11180,11277,97,6,2,0
774,"No", 1002,315,11103,11281,178,6,24,4
780,"No", 1010,215,11208,11298,90,2,12,3
781,"No", 1005 1004,218,11229,11309,80,4,1,0
784,"No", 1008,367,11267,11346,79,2,1,0
787,"No", 1010,304,11298,11356,58,2,0,0
785,"No", 1005,8,11274,11358,84,2,5,1
782,"No", 1009,115,11243,11364,121,2,18,2
778,"No", 1003,242,11186,11371,185,2,27,2
783,"No", 1001,202,11258,11389,131,6,10,1
788,"No", 1006 1004,211,11309,11429,120,4,16,1
789,"No", 1008,177,11346,11444,98,2,19,2
791,"No", 1005 1009,342,11358,11445,87,4,0,0
790,"No", 1010,112,11356,11448,92,2,3,0
796,"No", 1006,35,11429,11501,72,2,0,0
798,"No", 1009,324,11445,11518,73,2,2,1
795,"No", 1007,296,11420,11526,106,2,15,4
792,"No", 1003,93,11371,11546,175,2,44,0
797,"No", 1008,343,11444,11547,103,2,24,0
793,"No", 1005 1004 1001,282,11389,11550,161,6,52,2
799,"No", 1010,134,11448,11552,104,2,5,0
794,"No", 1001,160,11416,11563,147,2,40,3
786,"No", 1006 1002,186,11277,11563,286,4,135,6
800,"No", 1004,121,11465,11576,111,2,4,1
801,"No", 1006 1009,123,11501,11579,78,4,0,0
805,"No", 1005,343,11550,11608,58,2,0,0
803,"No", 1003,110,11546,11635,89,2,0,0
808,"No", 1004,64,11576,11652,76,2,0,0
802,"No", 1007,141,11526,11661,135,2,20,3
804,"No", 1008,153,11547,11661,114,2,6,2
806,"No", 1006 1001 1010,224,11552,11675,123,12,19,1
807,"No", 1002,148,11563,11696,133,2,28,1
812,"No", 1004,31,11652,11725,73,2,0,0
810,"No", 1005 1010,90,11608,11726,118,10,15,1
809,"No", 1009,44,11579,11731,152,6,15,0
813,"No", 1003,232,11660,11751,91,2,26,0
814,"No", 1008,281,11661,11756,95,2,10,0
811,"No", 1006 1003,85,11635,11757,122,4,10,0
816,"No", 1001,137,11675,11782,107,2,22,1
818,"No", 1005 1004,340,11714,11812,98,8,5,1
815,"No", 1007,203,11661,11814,153,6,46,4
822,"No", 1008,283,11756,11855,99,2,0,0
820,"No", 1005 1009,21,11731,11873,142,4,10,0
824,"No", 1001 1009,157,11782,11898,116,8,2,1
821,"No", 1003,242,11751,11921,170,2,52,3
828,"No", 1007,268,11871,11946,75,2,0,0
827,"No", 1008,16,11855,11970,115,2,22,0
817,"No", 1002,71,11696,11989,293,6,117,10
826,"No", 1007 1001,192,11814,12016,202,4,78,6
825,"No", 1004,233,11812,12028,216,2,96,4
831,"No", 1007,82,11946,12028,82,2,7,0
829,"No", 1005,340,11873,12039,166,2,73,4
823,"No", 1006,303,11757,12051,294,2,130,8
830,"No", 1003 1009,255,11898,12068,170,4,80,4
833,"No", 1009,149,11983,12078,95,2,5,0
819,"No", 1010,153,11726,12091,365,2,147,9
835,"No", 1001,32,12016,12108,92,2,12,2
832,"No", 1008,93,11970,12127,157,2,31,0
834,"No", 1002,204,11989,12150,161,6,10,1
837,"No", 1006 1003,370,12051,12162,111,4,2,1
838,"No", 1007,69,12074,12172,98,2,11,0
836,"No", 1007 1005 1004,77,12028,12176,148,10,17,2
839,"No", 1009,90,12078,12193,115,2,7,0
840,"No", 1006 1010,262,12091,12213,122,8,4,0
841,"No", 1004,188,12105,12215,110,2,0,0
842,"No", 1008 1002 1001,249,12108,12244,136,16,29,1
845,"No", 1005,378,12176,12261,85,2,0,0
846,"No", 1001 1009,263,12193,12289,96,6,17,0
849,"No", 1010,291,12217,12294,77,2,4,0
843,"No", 1003 1010,75,12159,12313,154,4,46,4
844,"No", 1007,151,12172,12328,156,2,15,0
850,"No", 1008 1002,306,12223,12346,123,4,5,1
847,"No", 1006,231,12213,12353,140,2,21,3
851,"No", 1005,216,12261,12361,100,2,13,3
848,"No", 1004,214,12215,12395,180,6,23,4
854,"No", 1009,86,12294,12402,108,2,21,0
853,"No", 1010,26,12294,12404,110,2,26,0
855,"No", 1008 1003,347,12304,12417,113,4,2,0
852,"No", 1001,356,12289,12434,145,2,28,5
856,"No", 1007,154,12328,12437,109,2,15,1
858,"No", 1005,164,12361,12443,82,2,0,0
861,"No", 1004,237,12395,12465,70,2,2,0
857,"No", 1006 1002,246,12346,12465,119,4,19,1
860,"No", 1002,111,12385,12481,96,2,6,0
859,"No", 1008,245,12362,12490,128,6,12,0
863,"No", 1003,357,12417,12498,81,6,1,0
862,"No", 1010 1009,81,12402,12510,108,4,5,1
864,"No", 1001,307,12434,12521,87,2,5,0
865,"No", 1007,161,12437,12550,113,2,12,2
869,"No", 1005,246,12485,12572,87,2,2,1
872,"No", 1010,215,12510,12592,82,2,6,1
867,"No", 1004,36,12465,12599,134,2,15,1
870,"No", 1008,279,12490,12606,116,2,2,0
866,"No", 1005 1009,330,12443,12606,163,4,24,3
873,"No", 1001,270,12521,12637,116,2,12,1
868,"No", 1006 1002,31,12465,12638,173,8,51,4
871,"No", 1003,211,12498,12648,150,6,24,1
874,"No", 1007 1005,98,12550,12650,100,8,5,0
875,"No", 1006,61,12583,12653,70,2,8,0
876,"No", 1004 1010 1009,167,12592,12682,90,6,3,0
880,"No", 1002,31,12638,12696,58,2,0,0
879,"No", 1001,70,12637,12739,102,2,2,1
882,"No", 1006 1005,27,12650,12745,95,4,14,0
878,"No", 1008,200,12637,12748,111,6,6,1
881,"No", 1003 1010,343,12647,12752,105,4,22,1
884,"No", 1009,41,12682,12766,84,2,3,0
877,"No", 1008 1007,324,12606,12776,170,4,31,1
886,"No", 1002,111,12696,12778,82,2,6,1
883,"No", 1004,78,12678,12779,101,2,10,0
887,"No", 1005,289,12706,12800,94,6,8,0
889,"No", 1008 1006,132,12745,12825,80,8,0,0
885,"No", 1010,126,12695,12853,158,6,11,3
890,"No", 1003,93,12752,12860,108,2,13,0
891,"No", 1007 1009,231,12766,12860,94,4,7,1
888,"No", 1001,135,12739,12864,125,2,25,1
894,"No", 1006,374,12817,12879,62,2,0,0
895,"No", 1009,142,12819,12911,92,2,3,0
893,"No", 1005 1004,248,12779,12914,135,4,3,1
897,"No", 1008,323,12825,12918,93,2,7,2
892,"No", 1002,190,12778,12926,148,6,12,0
896,"No", 1004,343,12819,12932,113,2,21,0
899,"No", 1007 1003,37,12860,12937,77,4,8,2
900,"No", 1006 1001,100,12864,12949,85,4,6,1
898,"No", 1010,45,12853,12980,127,2,4,0
901,"No", 1003,16,12885,13010,125,6,2,0
904,"No", 1001,91,12931,13032,101,2,16,1
906,"No", 1007,94,12937,13037,100,2,0,0
902,"No", 1009,365,12911,13037,126,6,24,0
905,"No", 1004,234,12932,13042,110,2,15,1
903,"No", 1008 1005 1002,296,12914,13047,133,10,31,0
907,"No", 1006 1010,28,12949,13055,106,8,1,0
908,"No", 1008 1005,302,12982,13091,109,4,8,0
909,"No", 1003,44,13010,13113,103,2,1,0
910,"No", 1001,152,13032,13135,103,2,0,0
914,"No", 1010,34,13055,13145,90,2,3,0
911,"No", 1007 1006 1009,181,13035,13171,136,10,18,2
915,"No", 1008,332,13070,13174,104,2,1,0
912,"No", 1004,48,13042,13180,138,8,21,2
917,"No", 1006 1009,290,13102,13204,102,4,2,0
919,"No", 1010,60,13145,13212,67,2,0,0
918,"No", 1003 1001,159,13113,13223,110,6,2,0
913,"No", 1002,30,13047,13224,177,2,40,3
916,"No", 1006 1005 1009,107,13072,13251,179,12,37,2
920,"No", 1006,362,13157,13253,96,2,0,0
925,"No", 1010 1009,100,13204,13279,75,7,3,0
921,"No", 1007,50,13171,13280,109,6,11,0
924,"No", 1004,291,13180,13284,104,2,4,2
922,"No", 1001,17,13171,13289,118,2,19,0
927,"No", 1005,279,13251,13325,74,2,0,0
928,"No", 1006 1010,231,13253,13334,81,4,0,0
923,"No", 1008,33,13174,13354,180,2,7,0
926,"No", 1003 1002,47,13223,13359,136,8,31,1
929,"No", 1007 1004,302,13280,13370,90,4,12,0
932,"No", 1007,26,13311,13387,76,2,6,2
931,"No", 1006 1009,327,13289,13399,110,8,5,0
930,"No", 1001,248,13289,13404,115,6,4,1
933,"No", 1005 1003 1010,362,13317,13457,140,6,13,2
934,"No", 1009,360,13352,13460,108,2,8,1
941,"No", 1008 1001,227,13404,13484,80,3,0,0
936,"No", 1003,17,13364,13486,122,2,26,3
938,"No", 1007,86,13387,13510,123,6,20,4
939,"No", 1005,82,13388,13512,124,2,9,1
940,"No", 1006,8,13399,13517,118,2,35,1
937,"No", 1004,167,13370,13527,157,2,27,1
935,"No", 1008 1002,14,13354,13530,176,8,75,3
945,"No", 1007 1003,120,13486,13578,92,4,6,2
943,"No", 1009,39,13460,13587,127,2,12,0
947,"No", 1006,288,13517,13588,71,2,0,0
944,"No", 1008 1001,320,13484,13616,132,8,23,1
948,"No", 1004,163,13527,13628,101,2,14,4
942,"No", 1010,43,13457,13632,175,2,10,1
946,"No", 1005,248,13512,13644,132,6,3,0
951,"No", 1009,172,13587,13645,58,2,1,0
952,"No", 1006,271,13588,13656,68,2,4,1
949,"No", 1003 1002,219,13530,13666,136,8,20,2
953,"No", 1008 1001,344,13612,13693,81,4,2,0
956,"No", 1005,32,13644,13722,78,2,4,0
950,"No", 1008 1007,280,13544,13728,184,4,17,1
958,"No", 1006 1002,194,13650,13734,84,4,10,1
955,"No", 1010,154,13632,13746,114,2,11,0
957,"No", 1009,209,13645,13773,128,6,14,3
959,"No", 1003,12,13666,13795,129,2,8,2
963,"No", 1005,340,13722,13833,111,6,17,1
962,"No", 1008,135,13718,13837,119,2,12,0
964,"No", 1007,245,13728,13853,125,6,9,1
954,"No", 1004,178,13628,13864,236,6,74,3
965,"No", 1006,345,13734,13869,135,2,31,1
966,"No", 1010 1009,200,13746,13879,133,4,36,0
967,"No", 1003,93,13795,13891,96,2,27,1
960,"No", 1008 1001,274,13675,13897,222,8,78,5
961,"No", 1002,159,13711,13906,195,2,55,1
968,"No", 1005 1010,111,13810,13934,124,4,9,1
972,"No", 1003,20,13891,13965,74,2,0,0
970,"No", 1007 1010,297,13842,13971,129,4,21,2
971,"No", 1006 1004 1009,187,13864,13971,107,10,8,1
969,"No", 1008,57,13837,14000,163,2,41,1
975,"No", 1005 1002 1001,314,13932,14043,111,6,56,2
973,"No", 1006 1002 1001,329,13897,14059,162,10,38,1
974,"No", 1004 1010,338,13923,14061,138,10,37,4
976,"No", 1003,90,13965,14063,98,2,0,0
980,"No", 1001,132,14015,14088,73,2,4,2
978,"No", 1010,107,13986,14095,109,2,17,1
979,"No", 1008,91,14000,14130,130,8,11,1
983,"No", 1002,332,14043,14134,91,2,6,2
977,"No", 1007 1009,351,13971,14135,164,4,24,0
981,"No", 1005,36,14020,14141,121,2,23,1
985,"No", 1004,280,14061,14146,85,2,0,0
982,"No", 1007,349,14039,14155,116,2,19,0
984,"No", 1006,123,14059,14168,109,6,18,0
987,"No", 1001,9,14088,14170,82,2,2,1
986,"No", 1003,338,14063,14180,117,8,16,1
988,"No", 1010,140,14095,14201,106,2,11,0
992,"No", 1005 1004,44,14141,14224,83,4,0,0
989,"No", 1008,307,14130,14224,94,2,13,0
990,"No", 1002,222,14134,14244,110,6,6,1
991,"No", 1009,201,14135,14244,109,6,14,1
995,"No", 1003 1010,109,14180,14283,103,4,5,0
994,"No", 1006 1001,203,14168,14301,133,4,16,3
993,"No", 1007,329,14155,14319,164,6,20,0
996,"No", 1006,263,14213,14320,107,2,0,0
998,"No", 1003,227,14242,14336,94,2,1,0
999,"No", 1002,136,14244,14341,97,2,7,1
1000,"No", 1009,95,14244,14349,105,2,6,2
997,"No", 1008 1005 1004,317,14222,14352,130,6,25,5
1003,"No", 1007,202,14319,14395,76,2,0,0
1001,"No", 1010,193,14283,14397,114,2,6,1
1002,"No", 1005 1004 1001,175,14291,14438,147,6,61,4
1011,"No", 1007,200,14395,14453,58,2,0,0
1007,"No", 1008,84,14352,14457,105,2,1,0
1010,"No", 1006,28,14379,14459,80,2,5,0
1006,"No", 1009,100,14349,14469,120,2,30,2
1009,"No", 1001,167,14366,14486,120,2,17,1
1012,"No", 1010,357,14397,14505,108,2,18,2
1004,"No", 1006 1003,4,14320,14515,195,8,62,5
1008,"No", 1005,53,14360,14542,182,6,68,4
1014,"No", 1008,252,14457,14544,87,2,1,0
1016,"No", 1009,137,14469,14570,101,2,1,0
1013,"No", 1007 1004,198,14438,14583,145,4,15,1
1017,"No", 1001,50,14486,14606,120,2,10,0
1018,"No", 1004 1010,225,14505,14618,113,4,23,1
1015,"No", 1006,207,14459,14621,162,2,13,3
1020,"No", 1008 1005,24,14542,14657,115,4,10,2
1019,"No", 1003,348,14515,14678,163,2,40,4
1022,"No", 1007 1009,379,14570,14678,108,4,0,0
1021,"No", 1010,93,14565,14704,139,6,13,1
1024,"No", 1001,67,14606,14707,101,2,12,0
1023,"No", 1005,81,14596,14719,123,2,10,2
1005,"No", 1002,162,14341,14725,384,8,206,7
1025,"No", 1009,139,14614,14764,150,2,12,3
1030,"No", 1004,132,14679,14770,91,2,0,0
1026,"No", 1008 1006 1004,206,14618,14770,152,6,37,1
1029,"No", 1003,25,14678,14781,103,2,4,1
1027,"No", 1006,137,14671,14788,117,2,10,1
1028,"No", 1007,293,14678,14823,145,8,3,0
1035,"No", 1002,22,14776,14864,88,2,2,0
1036,"No", 1003,139,14781,14880,99,2,0,0
1031,"No", 1005 1001 1010,357,14704,14897,193,6,95,3
1033,"No", 1008,55,14770,14900,130,2,29,3
1034,"No", 1004,365,14770,14902,132,2,38,3
1032,"No", 1002 1009,99,14725,14902,177,4,43,0
1040,"No", 1002,342,14864,14956,92,2,6,1
1037,"No", 1006,367,14788,14991,203,2,59,7
1039,"No", 1007,310,14823,14991,168,6,28,2
1043,"No", 1009,200,14902,14993,91,2,13,1
1041,"No", 1005 1003,286,14880,15003,123,4,9,0
1044,"No", 1004,372,14902,15006,104,2,20,1
1045,"No", 1003,159,14925,15016,91,2,4,1
1046,"No", 1010,217,14950,15022,72,2,2,1
1042,"No", 1008,218,14900,15025,125,2,12,0
1038,"No", 1001 1010,300,14798,15037,239,8,105,9
1048,"No", 1006,377,14991,15085,94,2,0,0
1049,"No", 1007 1009,149,14991,15108,117,4,26,1
1047,"No", 1002,321,14956,15114,158,2,35,1
1052,"No", 1008,251,15025,15122,97,2,7,2
1053,"No", 1001,13,15037,15136,99,2,9,1
1050,"No", 1005 1004,47,15003,15141,138,8,8,2
1051,"No", 1003 1010,267,15016,15152,136,4,36,0
1054,"No", 1005,27,15052,15157,105,2,5,0
1057,"No", 1009,126,15108,15197,89,6,1,0
1058,"No", 1002,66,15114,15205,91,2,0,0
1056,"No", 1003,39,15097,15217,120,2,11,0
1059,"No", 1008 1001,263,15122,15218,96,4,6,1
1055,"No", 1007 1006,146,15085,15239,154,8,20,1
1061,"No", 1006 1010,134,15147,15258,111,8,16,2
1065,"No", 1006,217,15204,15276,72,2,0,0
1062,"No", 1005,140,15157,15288,131,2,33,1
1063,"No", 1009,201,15197,15293,96,2,0,0
1067,"No", 1001,64,15218,15298,80,2,6,1
1060,"No", 1004,141,15141,15298,157,6,14,1
1066,"No", 1003 1002,20,15205,15309,104,4,6,2
1068,"No", 1007,234,15239,15340,101,2,1,0
1064,"No", 1008,205,15202,15347,145,6,12,1
1069,"No", 1002 1010,367,15255,15350,95,8,8,0
1075,"No", 1002,24,15315,15382,67,2,0,0
1073,"No", 1004,90,15298,15384,86,2,0,0
1074,"No", 1003,270,15309,15390,81,2,0,0
1072,"No", 1001,136,15298,15403,105,2,23,2
1071,"No", 1009,84,15293,15410,117,2,3,1
1077,"No", 1008,302,15347,15433,86,2,12,0
1070,"No", 1006 1005,117,15276,15438,162,8,32,1
1079,"No", 1006,162,15376,15454,78,6,0,0
1078,"No", 1010,233,15350,15458,108,2,5,0
1080,"No", 1002,48,15382,15480,98,2,3,0
1076,"No", 1007,11,15340,15515,175,2,38,3
1084,"No", 1009,53,15410,15528,118,2,48,1
1085,"No", 1008,182,15433,15530,97,2,7,1
1081,"No", 1004,39,15384,15532,148,2,15,3
1086,"No", 1005,76,15438,15547,109,2,32,1
1082,"No", 1003,149,15390,15557,167,2,57,1
1089,"No", 1002,48,15480,15560,80,2,0,0
1083,"No", 1001,65,15403,15574,171,2,52,2
1090,"No", 1007,15,15515,15624,109,2,8,2
1087,"No", 1006,148,15454,15628,174,2,15,0
1088,"No", 1010,87,15458,15630,172,2,22,3
1092,"No", 1008,84,15530,15633,103,2,2,0
1091,"No", 1009,119,15528,15661,133,2,7,0
1093,"No", 1005 1004,294,15532,15684,152,4,6,1
1094,"No", 1003 1002,283,15557,15685,128,4,13,0
1097,"No", 1003,99,15626,15696,70,2,6,2
1096,"No", 1007 1004,137,15585,15714,129,4,8,0
1100,"No", 1008,105,15633,15718,85,2,4,1
1099,"No", 1010,209,15630,15725,95,2,8,1
1095,"No", 1001,249,15574,15726,152,2,13,2
1098,"No", 1006,131,15628,15747,119,6,15,0
1101,"No", 1009,312,15661,15766,105,2,3,1
1102,"No", 1004,228,15673,15818,145,6,11,2
1105,"No", 1008 1007,70,15714,15819,105,4,3,1
1103,"No", 1005 1002,96,15684,15830,146,8,17,2
1107,"No", 1006,123,15747,15841,94,2,6,2
1104,"No", 1003,274,15696,15862,166,2,24,1
1110,"No", 1010 1009,341,15766,15892,126,4,9,2
1106,"No", 1001 1010,69,15725,15902,177,4,50,4
1109,"No", 1005,273,15761,15912,151,6,6,2
1113,"No", 1006 1009,365,15835,15938,103,4,3,0
1112,"No", 1008 1002,104,15819,15946,127,4,8,1
1114,"No", 1008 1003,371,15862,15957,95,3,22,3
1118,"No", 1005,8,15912,15982,70,2,0,0
1115,"No", 1009,251,15889,16016,127,2,21,1
1119,"No", 1006,247,15938,16055,117,2,10,1
1108,"No", 1007,231,15749,16059,310,6,62,6
1120,"No", 1008 1005 1002,125,15952,16074,122,10,27,2
1121,"No", 1003 1009,288,15994,16107,113,4,5,1
1122,"No", 1002,29,16027,16119,92,2,3,0
1116,"No", 1010,217,15892,16128,236,2,39,3
1124,"No", 1006,32,16055,16149,94,2,6,1
1123,"No", 1008,193,16028,16151,123,2,5,1
1117,"No", 1001,363,15902,16154,252,6,64,6
1126,"No", 1005,14,16074,16177,103,6,3,0
1127,"No", 1003 1009,347,16089,16183,94,8,5,1
1111,"No", 1004,267,15818,16184,366,2,97,5
1128,"No", 1002,146,16119,16206,87,2,3,0
1129,"No", 1010,19,16128,16215,87,2,0,0
1130,"No", 1003,123,16148,16255,107,2,11,1
1132,"No", 1001,29,16154,16263,109,2,3,1
1125,"No", 1007,55,16059,16265,206,10,24,1
1133,"No", 1005,199,16177,16267,90,2,9,0
1135,"No", 1004,70,16184,16269,85,2,4,1
1131,"No", 1008 1006,145,16149,16278,129,8,4,1
1134,"No", 1009,255,16183,16284,101,2,10,4
1136,"No", 1006,83,16186,16304,118,2,7,2
1138,"No", 1010,258,16215,16322,107,2,6,2
1137,"No", 1002,15,16206,16340,134,6,14,0
1139,"No", 1003 1001,17,16255,16367,112,4,11,3
1144,"No", 1006,317,16304,16374,70,2,0,0
1141,"No", 1005,262,16267,16396,129,6,2,1
1147,"No", 1008 1002,86,16325,16407,82,4,0,0
1145,"No", 1010,145,16322,16414,92,2,7,0
1143,"No", 1008 1009,114,16278,16418,140,4,6,0
1140,"No", 1007,214,16265,16425,160,8,13,0
1142,"No", 1004,360,16269,16434,165,2,51,0
1146,"No", 1003,282,16323,16441,118,2,11,0
1148,"No", 1008 1001,66,16362,16462,100,4,13,0
1149,"No", 1006 1005 1002,80,16374,16499,125,10,8,0
1151,"No", 1009,167,16418,16512,94,2,4,0
1158,"No", 1002,85,16499,16580,81,2,0,0
1154,"No", 1008,201,16448,16582,134,6,10,0
1157,"No", 1004,209,16494,16583,89,2,5,1
1156,"No", 1007 1005,82,16476,16610,134,4,2,0
1152,"No", 1007 1006,165,16425,16664,239,4,63,6
1161,"No", 1002,11,16580,16667,87,2,17,1
1160,"No", 1007,245,16567,16669,102,6,0,0
1162,"No", 1008 1004,80,16582,16691,109,3,94,7
1163,"No", 1005,82,16610,16700,90,2,22,2
1155,"No", 1001,258,16462,16730,268,6,91,4
1159,"No", 1007 1009,200,16510,16762,252,4,87,7
1153,"No", 1004 1003,348,16434,16773,339,4,106,8
1164,"No", 1006 1002,157,16664,16787,123,4,10,3
1150,"No", 1006 1010,324,16407,16798,391,8,96,3
1166,"No", 1007 1006 1005,220,16700,16823,123,11,14,1
1165,"No", 1007 1004,62,16669,16829,160,10,7,2
1168,"No", 1009,141,16762,16876,114,2,7,2
1167,"No", 1008 1001,340,16730,16900,170,4,43,2
1170,"No", 1002 1010,208,16787,16916,129,8,18,2
1173,"No", 1004,6,16829,16917,88,2,5,0
1171,"No", 1007,48,16823,16941,118,2,4,0
1172,"No", 1005,109,16824,16950,126,6,12,2
1175,"No", 1009,263,16876,16951,75,2,2,1
1174,"No", 1003 1002,45,16851,16961,110,8,7,1
1176,"No", 1008 1001,336,16880,16977,97,4,2,1
1177,"No", 1004 1010,84,16916,16998,82,8,0,0
1169,"No", 1008 1006 1003,327,16773,17050,277,16,173,1
1178,"No", 1008,89,16926,17050,124,2,17,2
1181,"No", 1009,249,16951,17065,114,2,1,0
1180,"No", 1005,35,16950,17068,118,6,21,2
1179,"No", 1007 1003,230,16930,17071,141,4,27,2
1182,"No", 1002 1001,349,16961,17089,128,8,12,1
1186,"No", 1002,113,17047,17117,70,2,1,0
1184,"No", 1003,84,17006,17124,118,2,8,2
1187,"No", 1008,321,17050,17137,87,2,0,0
1185,"No", 1010,265,17029,17149,120,2,11,1
1190,"No", 1001,35,17089,17155,66,2,3,0
1183,"No", 1004 1010,191,16979,17161,182,4,36,0
1188,"No", 1006 1009,239,17050,17178,128,4,9,0
1189,"No", 1007 1005,221,17068,17189,121,4,22,1
1192,"No", 1008 1003,153,17124,17221,97,4,6,1
1197,"No", 1004,348,17161,17239,78,2,2,1
1194,"No", 1005,212,17143,17245,102,2,5,1
1191,"No", 1002,258,17117,17250,133,6,5,1
1195,"No", 1010,186,17149,17273,124,6,5,1
1196,"No", 1001,136,17155,17285,130,2,11,0
1200,"No", 1003,222,17201,17295,94,2,5,0
1198,"No", 1009,16,17178,17298,120,2,6,1
1193,"No", 1006,3,17138,17328,190,6,28,3
1199,"No", 1007,82,17189,17330,141,2,13,1
1202,"No", 1004,277,17239,17333,94,2,0,0
1203,"No", 1005,226,17245,17339,94,6,5,1
1204,"No", 1002 1010,190,17250,17351,101,4,9,0
1201,"No", 1008,273,17221,17360,139,6,20,2
1206,"No", 1009,245,17298,17375,77,2,0,0
1205,"No", 1003 1002 1001,378,17285,17404,119,6,81,3
1208,"No", 1005 1004,299,17333,17431,98,4,5,1
1209,"No", 1008 1010,26,17351,17435,84,4,0,0
1207,"No", 1007 1006,51,17328,17452,124,4,28,3
1210,"No", 1009,338,17375,17460,85,2,0,0
1211,"No", 1003 1001,344,17386,17499,113,8,32,4
1212,"No", 1006,273,17393,17506,113,2,3,1
1213,"No", 1004 1002,345,17404,17521,117,8,14,2
1214,"No", 1010,117,17407,17567,160,2,27,1
1217,"No", 1009,205,17460,17577,117,2,33,1
1215,"No", 1008 1005,58,17431,17579,148,4,7,0
1218,"No", 1003 1002 1001,30,17463,17582,119,6,19,1
1216,"No", 1007,112,17452,17588,136,2,19,1
1219,"No", 1006,321,17506,17599,93,2,6,1
1220,"No", 1005 1004,145,17515,17620,105,4,7,1
1221,"No", 1003 1002,27,17528,17678,150,4,3,0
1224,"No", 1007 1006,371,17588,17683,95,7,17,2
1225,"No", 1004 1002,99,17604,17704,100,4,4,1
1223,"No", 1008 1001,197,17579,17710,131,4,28,3
1226,"No", 1010,135,17638,17724,86,2,0,0
1229,"No", 1005,347,17664,17754,90,2,1,0
1228,"No", 1008,357,17656,17758,102,2,6,2
1222,"No", 1005 1010 1009,139,17567,17760,193,18,15,0
1227,"No", 1002,350,17655,17761,106,2,3,0
1230,"No", 1003,225,17678,17766,88,2,1,0
1231,"No", 1006,3,17683,17790,107,2,9,2
1234,"No", 1010,200,17724,17834,110,2,4,1
1238,"No", 1003,51,17766,17843,77,2,0,0
1232,"No", 1004,343,17704,17844,140,2,4,0
1236,"No", 1008 1009,269,17758,17861,103,4,12,0
1233,"No", 1001,279,17710,17862,152,2,14,3
1237,"No", 1002,330,17761,17863,102,6,8,0
1235,"No", 1007 1005,285,17727,17885,158,4,25,3
1240,"No", 1008 1006,217,17790,17891,101,4,9,0
1239,"No", 1007,233,17788,17919,131,2,8,1
1243,"No", 1002 1001,10,17862,17969,107,4,7,0
1241,"No", 1004 1003 1010,374,17834,17974,140,6,49,2
1247,"No", 1006,338,17904,17981,77,2,4,1
1245,"No", 1008,121,17891,17983,92,2,11,0
1242,"No", 1009,68,17861,17992,131,2,9,0
1244,"No", 1005,16,17885,18019,134,2,22,0
1248,"No", 1007,59,17919,18035,116,6,4,0
1246,"No", 1010,351,17894,18043,149,2,48,1
1253,"No", 1001,175,17985,18061,76,2,0,0
1249,"No", 1003 1001,284,17933,18070,137,10,7,0
1250,"No", 1002,302,17969,18081,112,2,4,1
1251,"No", 1004,28,17974,18119,145,2,24,1
1252,"No", 1008 1006,244,17981,18131,150,12,21,1
1259,"No", 1002,66,18081,18153,72,2,3,0
1256,"No", 1010,98,18043,18153,110,2,13,1
1254,"No", 1005 1009,328,17992,18160,168,4,19,1
1258,"No", 1009,27,18075,18176,101,2,0,0
1257,"No", 1006 1003 1001,130,18052,18196,144,10,38,2
1255,"No", 1007,127,18035,18221,186,2,16,3
1260,"No", 1004,11,18119,18235,116,2,19,4
1266,"No", 1009,187,18176,18250,74,2,0,0
1262,"No", 1001,81,18148,18252,104,2,20,1
1264,"No", 1005,328,18160,18259,99,6,8,2
1263,"No", 1002 1010,296,18153,18276,123,4,8,1
1265,"No", 1006,314,18160,18287,127,6,4,0
1268,"No", 1007,245,18221,18294,73,2,0,0
1267,"No", 1003 1002,379,18196,18300,104,4,4,0
1261,"No", 1008,327,18131,18326,195,2,20,0
1269,"No", 1004,27,18235,18337,102,2,6,3
1272,"No", 1005,53,18259,18348,89,2,3,0
1271,"No", 1003,265,18255,18365,110,6,2,1
1270,"No", 1001 1009,182,18250,18369,119,8,11,0
1273,"No", 1010,341,18276,18377,101,2,8,0
1275,"No", 1007,299,18294,18423,129,2,0,0
1276,"No", 1008 1002,161,18300,18423,123,4,2,1
1274,"No", 1006,351,18287,18436,149,2,20,3
1277,"No", 1004,35,18337,18439,102,2,17,1
1279,"No", 1002,177,18354,18453,99,2,7,1
1280,"No", 1009,11,18357,18467,110,2,14,1
1278,"No", 1005,84,18348,18468,120,8,9,1
1281,"No", 1003 1001,115,18365,18471,106,4,6,0
1282,"No", 1010,343,18377,18479,102,2,20,2
1284,"No", 1008,367,18423,18482,59,2,0,0
1283,"No", 1003,218,18397,18497,100,2,3,0
1287,"No", 1002,324,18453,18507,54,2,2,1
1286,"No", 1006 1004,42,18436,18539,103,8,3,1
1289,"No", 1006,83,18469,18553,84,2,0,0
1290,"No", 1001,216,18471,18557,86,2,11,0
1288,"No", 1005 1009,29,18467,18567,100,4,6,1
1291,"No", 1008 1010,267,18479,18569,90,4,0,0
1285,"No", 1007,104,18423,18579,156,6,10,0
1292,"No", 1003,19,18497,18582,85,2,8,1
1298,"No", 1001,244,18557,18646,89,2,4,1
1299,"No", 1005,9,18567,18650,83,2,5,1
1295,"No", 1004,53,18539,18653,114,2,14,0
1296,"No", 1006,39,18553,18661,108,2,21,3
1297,"No", 1002,12,18555,18680,125,2,40,1
1293,"No", 1002 1010,165,18507,18685,178,8,32,2
1301,"No", 1007 1003,111,18579,18692,113,4,40,2
1300,"No", 1008,323,18569,18728,159,2,22,2
1294,"No", 1009,296,18535,18736,201,2,44,3
1303,"No", 1001,262,18646,18739,93,2,11,2
1306,"No", 1006 1002 1010,116,18661,18760,99,6,4,2
1302,"No", 1007,148,18637,18766,129,2,8,2
1304,"No", 1005,17,18650,18773,123,2,31,4
1307,"No", 1003,161,18692,18782,90,2,20,1
1305,"No", 1004,300,18653,18792,139,6,43,3
1308,"No", 1006,177,18695,18822,127,2,6,1
1309,"No", 1002,153,18722,18830,108,2,4,1
1314,"No", 1005,215,18773,18841,68,2,2,1
1310,"No", 1008 1009,188,18728,18869,141,8,16,2
1311,"No", 1001 1010,4,18739,18876,137,8,31,1
1317,"No", 1004,36,18792,18880,88,6,6,1
1312,"No", 1007,132,18766,18882,116,2,2,0
1316,"No", 1003,316,18782,18911,129,2,5,1
1319,"No", 1005,280,18841,18919,78,2,10,0
1313,"No", 1008,12,18770,18933,163,8,17,2
1315,"No", 1001,274,18780,18942,162,6,22,0
1318,"No", 1006 1002,21,18822,18962,140,4,31,4
1322,"No", 1004,65,18880,18992,112,2,1,0
1323,"No", 1007,165,18882,18995,113,2,3,2
1324,"No", 1005 1003,192,18911,19019,108,4,12,0
1325,"No", 1008,12,18933,19022,89,2,6,0
1321,"No", 1010,24,18876,19023,147,2,39,2
1320,"No", 1006 1009,357,18861,19037,176,8,57,2
1326,"No", 1002 1001,368,18942,19063,121,4,25,2
1328,"No", 1006,228,18968,19069,101,2,2,0
1331,"No", 1005,370,19019,19103,84,2,15,1
1327,"No", 1003,268,18968,19109,141,6,23,0
1330,"No", 1007 1001,310,18995,19121,126,4,20,3
1333,"No", 1010,297,19023,19138,115,2,1,0
1329,"No", 1004,36,18992,19141,149,2,9,1
1335,"No", 1002,21,19063,19152,89,2,4,1
1334,"No", 1007 1009,271,19037,19178,141,4,25,2
1337,"No", 1001,282,19121,19214,93,2,0,0
1332,"No", 1008,101,19022,19232,210,6,18,2
1339,"No", 1004,132,19141,19245,104,2,0,0
1336,"No", 1006 1005 1003,220,19069,19256,187,6,9,1
1340,"No", 1005 1002,41,19152,19265,113,4,14,1
1341,"No", 1007,43,19178,19275,97,2,17,2
1338,"No", 1006 1010 1009,235,19123,19281,158,12,59,1
1343,"No", 1008 1009,142,19221,19305,84,6,2,1
1342,"No", 1006 1002 1001,68,19186,19337,151,6,66,1
1346,"No", 1005 1003,164,19256,19348,92,4,3,1
1344,"No", 1004,251,19245,19356,111,2,7,2
1347,"No", 1007,19,19275,19380,105,6,6,1
1348,"No", 1010,356,19281,19391,110,2,7,2
1349,"No", 1008,87,19305,19411,106,2,5,0
1345,"No", 1006,269,19250,19418,168,2,31,1
1353,"No", 1004,186,19356,19441,85,2,5,0
1351,"No", 1002 1009,125,19329,19444,115,8,12,0
1350,"No", 1003 1001,362,19321,19448,127,4,40,3
1356,"No", 1010,372,19391,19491,100,2,2,1
1352,"No", 1005,341,19348,19492,144,8,34,0
1358,"No", 1004,198,19441,19504,63,2,2,1
1355,"No", 1007 1009,109,19379,19506,127,4,21,1
1357,"No", 1008 1006,75,19411,19522,111,4,20,0
1359,"No", 1009,16,19441,19542,101,2,7,0
1360,"No", 1002 1001,237,19444,19558,114,4,9,0
1354,"No", 1003,15,19375,19558,183,6,38,1
1361,"No", 1008,130,19481,19566,85,2,5,1
1363,"No", 1004,233,19504,19574,70,2,1,0
1365,"No", 1002,112,19507,19605,98,2,0,0
1362,"No", 1005 1010,42,19491,19606,115,4,12,1
1364,"No", 1007,3,19506,19611,105,2,14,2
1366,"No", 1006 1010,12,19522,19651,129,4,16,1
1368,"No", 1003 1001,153,19558,19652,94,8,8,1
1371,"No", 1006,29,19591,19664,73,2,0,0
1372,"No", 1002,11,19605,19688,83,2,2,0
1370,"No", 1004,201,19574,19688,114,2,2,0
1367,"No", 1009,246,19542,19692,150,2,10,2
1369,"No", 1008,198,19566,19697,131,6,4,0
1374,"No", 1007,85,19611,19708,97,2,12,2
1375,"No", 1003,345,19619,19711,92,2,5,0
1373,"No", 1005,114,19606,19715,109,2,2,1
1376,"No", 1006 1001 1010,110,19651,19747,96,9,27,1
1378,"No", 1009,230,19692,19797,105,2,7,0
1380,"No", 1003,15,19711,19798,87,2,7,2
1377,"No", 1004 1002,244,19688,19803,115,8,20,2
1382,"No", 1006 1004,203,19736,19850,114,4,2,0
1379,"No", 1008 1007,306,19697,19850,153,4,23,0
1381,"No", 1005 1010,17,19715,19852,137,10,36,2
1384,"No", 1001,27,19749,19861,112,6,17,1
1383,"No", 1008,51,19748,19862,114,2,24,1
1386,"No", 1004 1009,237,19784,19879,95,4,14,1
1387,"No", 1003,42,19798,19894,96,2,6,2
1385,"No", 1005,314,19777,19898,121,6,17,0
1389,"No", 1007 1006,207,19850,19939,89,4,6,0
1391,"No", 1008 1001,251,19861,19949,88,4,13,0
1388,"No", 1004 1002,163,19803,19969,166,4,30,1
1392,"No", 1002,277,19878,19980,102,2,4,2
1390,"No", 1010,24,19852,19980,128,2,23,1
1393,"No", 1003 1009,160,19879,20008,129,4,16,2
1394,"No", 1005,68,19898,20009,111,2,13,1
1396,"No", 1006,51,19933,20009,76,2,5,0
1395,"No", 1001,11,19920,20018,98,2,17,2
1398,"No", 1009,330,19943,20023,80,2,2,0
1397,"No", 1007,37,19939,20040,101,2,6,1
1399,"No", 1008 1004,247,19949,20043,94,4,0,0
1400,"No", 1002 1010,315,19980,20054,74,4,8,1
1404,"No", 1008,200,20019,20086,67,2,0,0
1402,"No", 1005,245,20009,20095,86,2,0,0
1401,"No", 1006,268,20009,20120,111,6,8,1
1405,"No", 1009,272,20023,20127,104,2,7,0
1407,"No", 1004 1002,198,20043,20136,93,4,5,0
1406,"No", 1007,34,20040,20157,117,2,8,0
1408,"No", 1008 1010,152,20054,20157,103,4,0,0
1403,"No", 1003 1001,39,20014,20159,145,4,29,2
1409,"No", 1003,188,20093,20189,96,2,3,0
1410,"No", 1005,33,20095,20200,105,2,0,0
1414,"No", 1008,60,20157,20234,77,2,2,0
1411,"No", 1006 1010 1009,187,20120,20243,123,10,10,3
1413,"No", 1002,307,20136,20254,118,2,15,0
1415,"No", 1007,67,20157,20262,105,2,2,1
1412,"No", 1004,290,20130,20284,154,6,14,2
1419,"No", 1009,166,20243,20301,58,2,0,0
1417,"No", 1003 1001,50,20189,20302,113,4,10,1
1420,"No", 1002,20,20254,20346,92,2,0,0
1418,"No", 1008 1005 1010,2,20200,20347,147,6,38,6
1416,"No", 1006 1001 1010,258,20159,20357,198,12,17,1
1424,"No", 1009,87,20301,20370,69,2,15,1
1421,"No", 1007,119,20262,20383,121,2,17,3
1425,"No", 1001 1010,200,20302,20407,105,8,9,1
1427,"No", 1008,201,20347,20425,78,2,5,1
1422,"No", 1003,219,20263,20432,169,6,31,3
1423,"No", 1004,162,20284,20450,166,6,20,0
1426,"No", 1005 1002,44,20308,20451,143,4,4,0
1428,"No", 1006 1005,160,20353,20465,112,4,12,1
1429,"No", 1001 1009,188,20368,20471,103,4,4,1
1430,"No", 1007,11,20383,20497,114,6,4,0
1431,"No", 1005 1010,77,20407,20518,111,4,19,1
1434,"No", 1004,135,20450,20531,81,2,3,0
1432,"No", 1001,109,20417,20532,115,2,10,1
1435,"No", 1006 1002,174,20451,20550,99,4,12,0
1436,"No", 1009,119,20471,20574,103,2,7,3
1433,"No", 1008 1003,20,20425,20575,150,8,35,2
1437,"No", 1007,110,20497,20597,100,2,1,0
1438,"No", 1010,217,20501,20599,98,2,15,4
1439,"No", 1008,372,20517,20625,108,6,8,1
1440,"No", 1005,12,20518,20633,115,6,15,1
1441,"No", 1004 1002,320,20520,20644,124,8,39,0
1442,"No", 1001,270,20532,20659,127,2,6,1
1444,"No", 1003 1009,303,20574,20667,93,4,3,0
1446,"No", 1010,11,20599,20694,95,2,0,0
1443,"No", 1006,310,20550,20701,151,6,11,2
1445,"No", 1007 1002,120,20597,20715,118,4,5,1
1447,"No", 1009,209,20614,20715,101,2,12,0
1448,"No", 1008,172,20625,20717,92,2,14,1
1452,"No", 1010,265,20694,20757,63,2,2,1
1451,"No", 1003,194,20667,20764,97,2,6,2
1450,"No", 1004 1001,191,20644,20770,126,3,21,1
1449,"No", 1005 1002,141,20633,20776,143,12,25,1
1453,"No", 1007 1006,14,20701,20790,89,4,0,0
1456,"No", 1008,21,20717,20830,113,2,13,1
1454,"No", 1009,154,20715,20840,125,6,4,0
1455,"No", 1005,75,20716,20853,137,2,10,0
1457,"No", 1010,95,20757,20857,100,2,6,1
1458,"No", 1006 1003,71,20757,20862,105,4,48,2
1461,"No", 1007,166,20790,20886,96,2,5,1
1463,"No", 1008,228,20830,20920,90,2,2,1
1459,"No", 1001,110,20770,20927,157,2,33,2
1460,"No", 1004 1002,58,20776,20928,152,8,18,1
1462,"No", 1002,233,20812,20944,132,2,14,0
1464,"No", 1009,32,20840,20951,111,6,4,1
1467,"No", 1006,145,20876,20956,80,2,4,1
1466,"No", 1003 1010,230,20857,20963,106,4,13,2
1465,"No", 1005,107,20853,20993,140,2,24,1
1468,"No", 1007,237,20886,21000,114,4,6,1
1471,"No", 1002 1010 1009,321,20929,21024,95,10,7,1
1469,"No", 1008,47,20920,21047,127,6,15,1
1470,"No", 1004 1001,64,20927,21049,122,4,41,2
1472,"No", 1006 1003,344,20956,21057,101,4,4,0
1476,"No", 1004,255,21049,21167,118,2,0,0
1473,"No", 1007 1005 1001,340,20988,21183,195,14,120,10
1477,"No", 1003 1001,332,21057,21214,157,4,14,2
1479,"No", 1003,165,21133,21243,110,6,24,0
1481,"No", 1004,197,21167,21265,98,2,14,1
1483,"No", 1001,2,21214,21290,76,2,0,0
1475,"No", 1008 1002 1009,202,21022,21296,274,9,278,13
1486,"No", 1006,146,21266,21304,38,2,0,0
1484,"No", 1003,262,21243,21316,73,2,0,0
1485,"No", 1004,191,21265,21331,66,2,0,0
1489,"No", 1006,3,21304,21400,96,2,4,2
1491,"No", 1003,231,21316,21410,94,2,0,0
1478,"No", 1009,258,21117,21413,296,2,112,12
1487,"No", 1001,234,21290,21416,126,2,20,2
1488,"No", 1008,34,21296,21424,128,2,39,1
1490,"No", 1002,33,21314,21431,117,2,32,3
1482,"No", 1007,277,21183,21431,248,2,107,8
1474,"No", 1006 1010,360,21014,21445,431,4,259,9
1480,"No", 1005,230,21148,21455,307,8,120,10
1492,"No", 1004,77,21331,21480,149,4,16,1
1493,"No", 1006,4,21400,21502,102,2,2,1
1494,"No", 1003,299,21413,21508,95,2,21,0
1496,"No", 1008,164,21424,21529,105,2,1,0
1495,"No", 1001 1009,91,21413,21532,119,4,15,1
1498,"No", 1005,367,21461,21541,80,2,6,1
1500,"No", 1009,136,21481,21560,79,2,0,0
1499,"No", 1004,231,21480,21585,105,2,0,0
1503,"No", 1008,104,21529,21594,65,2,0,0
1501,"No", 1007,255,21490,21602,112,2,1,0
1497,"No", 1007 1002 1010,300,21432,21614,182,10,85,3
1502,"No", 1006 1003 1002,279,21502,21641,139,6,55,2
1511,"No", 1007,145,21602,21641,39,2,0,0
1504,"No", 1005 1001,134,21532,21674,142,8,20,2
1510,"No", 1008,198,21594,21675,81,2,1,0
1507,"No", 1003,3,21586,21683,97,2,3,1
1509,"No", 1001,233,21594,21684,90,2,4,2
1505,"No", 1009,98,21560,21685,125,2,32,3
1506,"No", 1006,87,21571,21738,167,8,56,2
1508,"No", 1004,21,21591,21754,163,2,51,3
1512,"No", 1010,163,21614,21762,148,6,25,2
1513,"No", 1007 1002,253,21641,21765,124,4,16,3
1516,"No", 1001,57,21684,21777,93,6,2,1
1514,"No", 1008 1005,160,21674,21803,129,4,9,2
1515,"No", 1003,363,21683,21804,121,2,13,2
1517,"No", 1009,281,21685,21818,133,2,4,1
1519,"No", 1006,100,21738,21844,106,2,7,1
1522,"No", 1007 1002,214,21765,21869,104,4,18,0
1518,"No", 1005 1002,379,21688,21877,189,4,35,3
1520,"No", 1004 1002,291,21746,21901,155,8,36,2
1524,"No", 1008,25,21803,21903,100,2,14,0
1521,"No", 1010,228,21762,21908,146,2,38,0
1525,"No", 1003,354,21804,21914,110,2,10,2
1527,"No", 1002,214,21869,21946,77,2,1,0
1530,"No", 1009,220,21888,21964,76,2,4,1
1523,"No", 1001,16,21777,21972,195,6,19,2
1529,"No", 1007,264,21885,21997,112,8,4,1
1526,"No", 1007 1006 1009,206,21807,22016,209,6,28,1
1528,"No", 1005,22,21877,22023,146,2,20,0
1531,"No", 1004,151,21901,22040,139,2,28,2
1535,"No", 1002,224,21946,22044,98,2,17,2
1532,"No", 1008,8,21903,22047,144,2,12,1
1533,"No", 1010,27,21908,22047,139,2,29,5
1534,"No", 1003,121,21914,22088,174,8,30,4
1540,"No", 1007,267,22035,22133,98,2,4,0
1542,"No", 1008,115,22047,22142,95,2,3,0
1543,"No", 1010,145,22047,22147,100,2,5,1
1536,"No", 1009,65,21964,22151,187,2,65,3
1538,"No", 1007 1006,342,21997,22153,156,4,1,0
1537,"No", 1001,306,21972,22158,186,2,67,0
1541,"No", 1004 1002,80,22040,22160,120,4,38,3
1539,"No", 1005,14,22023,22168,145,2,43,1
1545,"No", 1004,32,22122,22185,63,2,2,0
1544,"No", 1003,91,22088,22187,99,2,15,0
1546,"No", 1007,200,22133,22204,71,2,2,0
1547,"No", 1008,9,22142,22249,107,6,3,0
1549,"No", 1006 1009,347,22151,22250,99,4,4,1
1553,"No", 1003,37,22187,22268,81,2,0,0
1548,"No", 1010,13,22147,22279,132,2,13,1
1550,"No", 1001,188,22158,22285,127,2,6,0
1552,"No", 1004,140,22185,22313,128,2,14,0
1555,"No", 1009,294,22206,22319,113,2,5,2
1554,"No", 1007,203,22204,22323,119,6,11,2
1551,"No", 1005 1002,358,22160,22331,171,4,90,4
1556,"No", 1008,11,22249,22355,106,2,7,2
1557,"No", 1006,224,22250,22363,113,2,11,0
1558,"No", 1003,149,22268,22367,99,2,1,0
1559,"No", 1001 1010,4,22279,22371,92,4,7,0
1564,"No", 1010,45,22324,22404,80,2,3,0
1567,"No", 1006,177,22363,22420,57,2,2,0
1562,"No", 1009,34,22319,22420,101,2,16,1
1560,"No", 1002,161,22288,22428,140,6,11,1
1565,"No", 1005,32,22331,22436,105,2,2,1
1568,"No", 1001,272,22371,22458,87,2,3,0
1561,"No", 1004,105,22313,22476,163,6,14,1
1569,"No", 1003 1010,374,22373,22485,112,4,13,3
1563,"No", 1007,77,22323,22486,163,8,11,1
1574,"No", 1001,85,22458,22525,67,2,1,0
1573,"No", 1003,139,22437,22534,97,2,0,0
1575,"No", 1004,8,22476,22572,96,6,0,0
1570,"No", 1006 1009,125,22420,22591,171,12,39,6
1579,"No", 1001,47,22525,22618,93,2,5,0
1566,"No", 1008,11,22355,22639,284,6,121,2
1578,"No", 1009,368,22514,22639,125,6,7,3
1581,"No", 1004,224,22572,22661,89,2,4,0
1572,"No", 1005,227,22436,22684,248,2,54,1
1576,"No", 1010,96,22485,22689,204,2,62,3
1577,"No", 1007,347,22486,22703,217,6,81,0
1580,"No", 1003,281,22534,22706,172,2,56,3
1584,"No", 1008,163,22639,22716,77,2,0,0
1571,"No", 1002,13,22428,22728,300,8,138,2
1587,"No", 1005,159,22684,22763,79,2,5,0
1586,"No", 1004,178,22661,22768,107,2,2,0
1585,"No", 1009,249,22639,22772,133,2,5,0
1582,"No", 1006 1001,343,22591,22779,188,4,57,0
1583,"No", 1006,48,22626,22790,164,2,72,0
1589,"No", 1007,377,22703,22791,88,2,12,0
1590,"No", 1003,283,22706,22804,98,2,20,0
1592,"No", 1002,57,22728,22812,84,2,6,0
1591,"No", 1008,193,22716,22832,116,2,3,1
1593,"No", 1005 1004,26,22763,22865,102,4,15,2
1588,"No", 1010,274,22689,22870,181,2,29,4
1596,"No", 1007 1005,220,22791,22884,93,4,3,1
1598,"No", 1002,101,22812,22917,105,2,8,2
1594,"No", 1001 1009,20,22772,22921,149,8,18,1
1600,"No", 1009,59,22834,22934,100,2,1,0
1599,"No", 1008,232,22832,22941,109,2,13,2
1601,"No", 1007,211,22853,22948,95,2,10,2
1597,"No", 1003,151,22804,22951,147,2,20,2
1602,"No", 1004,43,22865,23001,136,2,20,2
1605,"No", 1008 1009,15,22934,23030,96,4,0,0
1608,"No", 1002,44,22969,23057,88,2,5,0
1603,"No", 1005 1010,69,22870,23057,187,4,64,8
1604,"No", 1002 1001,154,22917,23080,163,4,21,0
1609,"No", 1007,365,22983,23103,120,2,7,1
1610,"No", 1009,79,22987,23109,122,2,4,1
1607,"No", 1003,197,22951,23122,171,2,23,4
1612,"No", 1008 1005 1002,99,23030,23140,110,9,5,1
1595,"No", 1006,28,22790,23166,376,2,93,9
1615,"No", 1008,9,23111,23185,74,2,0,0
1614,"No", 1007 1009,304,23103,23212,109,7,49,3
1616,"No", 1003,20,23122,23233,111,2,19,2
1606,"No", 1007 1010,41,22948,23238,290,8,76,8
1613,"No", 1001,27,23080,23242,162,10,29,0
1611,"No", 1004,330,23001,23262,261,6,74,4
1617,"No", 1005,32,23140,23286,146,6,6,0
1618,"No", 1002,365,23141,23294,153,6,55,1
1619,"No", 1008 1006,141,23166,23305,139,8,72,0
1621,"No", 1007 1010,241,23238,23332,94,4,13,1
1622,"No", 1001,55,23242,23334,92,2,6,1
1623,"No", 1009,279,23256,23347,91,2,2,1
1626,"No", 1002,174,23294,23375,81,2,6,1
1627,"No", 1008 1010,272,23305,23400,95,3,18,1
1628,"No", 1007,347,23332,23421,89,2,4,2
1624,"No", 1004,95,23262,23430,168,2,25,4
1630,"No", 1009,98,23347,23437,90,2,1,0
1629,"No", 1001,199,23334,23440,106,2,9,0
1625,"No", 1006 1005,323,23282,23442,160,12,7,1
1620,"No", 1003 1009,312,23212,23454,242,6,42,1
1633,"No", 1007,30,23421,23512,91,2,4,2
1634,"No", 1008,354,23427,23515,88,2,2,1
1632,"No", 1006,39,23414,23524,110,2,9,1
1635,"No", 1004,41,23430,23531,101,2,11,0
1638,"No", 1005 1002,290,23442,23571,129,4,24,1
1631,"No", 1002 1010,70,23375,23583,208,8,35,2
1637,"No", 1001,113,23440,23584,144,6,23,3
1636,"No", 1009,47,23437,23597,160,6,29,1
1640,"No", 1008,24,23515,23619,104,2,13,0
1642,"No", 1005,320,23531,23621,90,2,6,2
1644,"No", 1003 1002,44,23549,23643,94,4,2,0
1639,"No", 1007 1003,12,23454,23648,194,4,32,2
1643,"No", 1004,62,23531,23660,129,2,20,2
1645,"No", 1010,43,23583,23678,95,2,4,0
1646,"No", 1001,218,23584,23680,96,2,9,0
1648,"No", 1008 1003,374,23613,23743,130,8,41,2
1641,"No", 1006,119,23524,23757,233,2,47,2
1647,"No", 1009,33,23597,23770,173,6,27,1
1652,"No", 1005 1004,126,23700,23790,90,4,11,1
1650,"No", 1004 1010,181,23660,23799,139,4,5,1
1653,"No", 1003 1002,80,23729,23831,102,8,0,0
1657,"No", 1009,232,23770,23891,121,6,0,0
1658,"No", 1005,215,23790,23904,114,2,5,1
1655,"No", 1004,12,23755,23942,187,2,92,2
1656,"No", 1006 1002,372,23757,23943,186,8,83,2
1659,"No", 1003 1010,216,23799,23951,152,4,50,2
1654,"No", 1008,11,23743,23952,209,2,122,0
1662,"No", 1010,80,23893,23961,68,2,16,1
1660,"No", 1006,194,23837,23962,125,6,11,2
1651,"No", 1001,76,23680,23973,293,2,174,4
1661,"No", 1009,96,23891,24014,123,6,17,1
1663,"No", 1007,310,23897,24035,138,2,21,2
1664,"No", 1005 1004,15,23904,24039,135,4,3,0
1666,"No", 1008 1003 1010,78,23951,24084,133,6,62,1
1668,"No", 1001,206,23973,24086,113,2,5,2
1667,"No", 1006,265,23962,24089,127,2,18,0
1669,"No", 1003 1009,66,24004,24101,97,4,2,1
1665,"No", 1005 1002,293,23943,24132,189,14,54,3
1670,"No", 1008 1007,6,24033,24143,110,8,40,0
1673,"No", 1002,263,24064,24148,84,2,12,1
1671,"No", 1004,274,24039,24167,128,2,23,1
1676,"No", 1009,67,24101,24172,71,2,9,0
1672,"No", 1003,136,24056,24174,118,2,0,0
1674,"No", 1001 1010,245,24084,24180,96,4,5,0
1675,"No", 1006,4,24089,24201,112,2,2,0
1677,"No", 1005,153,24132,24226,94,2,1,0
1680,"No", 1002,296,24148,24235,87,2,4,1
1679,"No", 1008 1007,238,24138,24247,109,12,0,0
1681,"No", 1004,211,24167,24271,104,2,0,0
1678,"No", 1010,205,24134,24271,137,6,0,0
1682,"No", 1003 1009,330,24172,24304,132,8,22,1
1684,"No", 1008,255,24217,24326,109,2,8,0
1686,"No", 1002,239,24235,24334,99,2,0,0
1687,"No", 1009,200,24239,24335,96,2,22,1
1685,"No", 1005,141,24226,24345,119,2,28,1
1683,"No", 1006 1001,265,24180,24354,174,4,37,0
1688,"No", 1007 1001,61,24247,24359,112,4,14,1
1689,"No", 1004 1010,212,24271,24369,98,4,16,2
1690,"No", 1003,290,24304,24372,68,2,4,0
1693,"No", 1009,175,24335,24436,101,2,6,1
1694,"No", 1005,367,24345,24437,92,2,1,0
1691,"No", 1008 1007,33,24315,24443,128,8,26,1
1696,"No", 1001,209,24359,24460,101,2,2,0
1698,"No", 1004,247,24386,24489,103,2,4,1
1699,"No", 1007,126,24394,24507,113,2,17,1
1702,"No", 1005,89,24437,24526,89,2,9,1
1697,"No", 1003 1010,76,24369,24529,160,4,58,7
1695,"No", 1006,82,24354,24532,178,2,38,8
1703,"No", 1008,190,24443,24534,91,2,11,0
1692,"No", 1004 1002,348,24334,24543,209,4,48,6
1700,"No", 1010,227,24421,24547,126,2,4,0
1704,"No", 1004 1001,68,24460,24554,94,4,5,0
1706,"No", 1006,194,24532,24587,55,2,0,0
1705,"No", 1007 1005 1003,142,24507,24610,103,6,21,1
1707,"No", 1008 1001,351,24534,24642,108,4,12,1
1709,"No", 1008 1006 1004,104,24554,24645,91,7,4,1
1708,"No", 1002 1010,340,24543,24652,109,4,22,0
1701,"No", 1009,365,24436,24664,228,8,39,2
1710,"No", 1007,286,24587,24684,97,2,1,0
1711,"No", 1005 1003,207,24604,24694,90,4,6,0
1714,"No", 1004,252,24652,24749,97,2,6,2
1712,"No", 1001,239,24642,24756,114,8,3,0
1713,"No", 1006 1002,166,24645,24757,112,12,17,2
1716,"No", 1008,131,24671,24778,107,2,5,0
1715,"No", 1010 1009,273,24652,24786,134,8,21,2
1717,"No", 1007,105,24684,24804,120,2,8,0
1719,"No", 1005,85,24722,24827,105,2,4,1
1718,"No", 1005 1003 1010,344,24688,24833,145,6,32,3
1720,"No", 1006 1004,222,24735,24848,113,8,22,0
1721,"No", 1002 1001,37,24756,24866,110,4,12,1
1724,"No", 1006 1004 1010,9,24833,24917,84,4,73,1
1722,"No", 1008 1003 1009,342,24778,24925,147,14,59,3
1725,"No", 1008 1002,101,24862,24973,111,8,22,3
1729,"No", 1004,272,24917,24987,70,2,3,1
1726,"No", 1007,225,24870,25001,131,2,17,2
1728,"No", 1001,22,24880,25005,125,2,14,1
1723,"No", 1007 1005 1001,167,24804,25009,205,6,56,2
1727,"No", 1009,270,24880,25016,136,2,19,3
1730,"No", 1010,253,24921,25029,108,8,4,0
1733,"No", 1008,201,24967,25031,64,2,0,0
1732,"No", 1006,251,24963,25066,103,2,2,1
1734,"No", 1002,141,24973,25084,111,2,7,1
1731,"No", 1003,114,24925,25089,164,2,33,3
1735,"No", 1007 1004,204,24987,25091,104,8,14,0
1738,"No", 1009,14,25016,25097,81,2,0,0
1737,"No", 1005,303,25009,25127,118,2,16,1
1736,"No", 1001,329,25005,25136,131,2,25,0
1740,"No", 1008 1004,98,25031,25137,106,4,0,0
1739,"No", 1010,178,25029,25137,108,2,2,0
1741,"No", 1008 1006 1002,286,25059,25179,120,6,22,1
1745,"No", 1001,148,25136,25206,70,2,4,0
1743,"No", 1007 1009,338,25091,25208,117,4,7,1
1748,"No", 1008 1006,302,25141,25215,74,6,6,2
1744,"No", 1005,209,25127,25229,102,2,5,0
1746,"No", 1010,258,25137,25241,104,2,17,0
1742,"No", 1003,350,25089,25256,167,6,11,2
1749,"No", 1007 1002,219,25148,25265,117,4,6,3
1747,"No", 1004,16,25137,25272,135,6,9,1
1751,"No", 1001,3,25206,25322,116,6,8,1
1750,"No", 1007,125,25183,25338,155,6,13,0
1752,"No", 1006 1009,127,25208,25339,131,4,17,2
1753,"No", 1008,198,25228,25349,121,2,17,0
1757,"No", 1004 1002,84,25265,25378,113,10,30,1
1755,"No", 1009,327,25248,25402,154,2,28,1
1758,"No", 1005,342,25290,25405,115,2,15,0
1759,"No", 1001,372,25322,25407,85,2,0,0
1756,"No", 1003,208,25256,25428,172,2,52,1
1760,"No", 1007 1006,80,25338,25439,101,4,10,2
1762,"No", 1002,228,25353,25441,88,2,2,0
1761,"No", 1008,83,25349,25473,124,2,0,0
1763,"No", 1007 1004,368,25378,25497,119,4,21,1
1766,"No", 1001,278,25407,25515,108,6,7,0
1765,"No", 1005,55,25405,25516,111,2,0,0
1773,"No", 1001,190,25515,25591,76,2,0,0
1770,"No", 1008 1004,252,25473,25591,118,4,19,2
1771,"No", 1007,82,25497,25593,96,2,0,0
1772,"No", 1010,224,25499,25598,99,2,24,3
1768,"No", 1006,351,25439,25600,161,2,53,5
1764,"No", 1009,3,25402,25638,236,6,93,6
1775,"No", 1005,132,25516,25640,124,2,18,1
1767,"No", 1004 1003,100,25418,25664,246,8,70,2
1769,"No", 1002,342,25441,25672,231,6,76,4
1777,"No", 1007,212,25593,25680,87,2,8,1
1776,"No", 1004 1001,246,25591,25693,102,4,8,2
1774,"No", 1008,242,25515,25711,196,2,44,2
1778,"No", 1010,255,25598,25714,116,2,16,0
1779,"No", 1006 1005 1009,123,25600,25715,115,11,11,1
1780,"No", 1003,368,25664,25753,89,2,2,1
1781,"No", 1006 1002,157,25672,25767,95,4,9,0
1783,"No", 1007,91,25680,25792,112,2,28,0
1784,"No", 1004,360,25693,25802,109,2,17,1
1786,"No", 1005 1010,90,25714,25813,99,4,20,0
1787,"No", 1002,11,25735,25819,84,2,2,0
1789,"No", 1006,303,25767,25836,69,2,0,0
1785,"No", 1008,163,25711,25854,143,2,27,2
1790,"No", 1009,362,25767,25861,94,2,3,1
1788,"No", 1003 1010,21,25753,25863,110,4,7,1
1782,"No", 1001,251,25674,25872,198,2,20,1
1791,"No", 1007 1003,79,25792,25881,89,4,7,1
1792,"No", 1004,104,25802,25920,118,2,15,0
1796,"No", 1009,306,25861,25930,69,2,2,1
1798,"No", 1001,127,25872,25962,90,2,2,1
1793,"No", 1006 1005 1002,312,25813,25970,157,6,15,2
1794,"No", 1007,228,25854,25976,122,2,28,4
1799,"No", 1003,191,25881,25981,100,2,8,0
1801,"No", 1004 1002,237,25903,25992,89,4,27,0
1800,"No", 1005,65,25886,25999,113,2,22,0
1797,"No", 1010,93,25863,26025,162,2,48,5
1795,"No", 1008,3,25854,26041,187,8,62,2
1805,"No", 1007,73,25976,26056,80,2,0,0
1804,"No", 1006,24,25970,26058,88,2,11,1
1803,"No", 1002 1001,320,25962,26082,120,8,4,1
1806,"No", 1005 1004 1003,116,25981,26103,122,20,27,0
1807,"No", 1001,246,26004,26105,101,2,5,1
1808,"No", 1010,289,26025,26128,103,2,5,1
1802,"No", 1009,19,25930,26141,211,2,58,2
1811,"No", 1006,165,26058,26147,89,2,10,1
1813,"No", 1004,8,26088,26149,61,2,0,0
1809,"No", 1003,224,26029,26175,146,2,22,2
1810,"No", 1008 1007,316,26041,26181,140,4,21,0
1814,"No", 1008,29,26097,26204,107,2,4,1
1812,"No", 1002,145,26082,26209,127,2,16,0
1815,"No", 1005,154,26103,26218,115,2,10,2
1816,"No", 1001,162,26105,26234,129,2,19,0
1817,"No", 1010,300,26128,26258,130,6,21,1
1818,"No", 1006 1009,280,26141,26271,130,8,14,2
1819,"No", 1004,262,26149,26281,132,2,19,3
1821,"No", 1009,255,26204,26281,77,2,10,2
1822,"No", 1008,281,26204,26299,95,2,3,0
1820,"No", 1007 1003,272,26175,26300,125,8,22,1
1824,"No", 1005 1001,10,26218,26329,111,7,39,2
1828,"No", 1009,164,26281,26366,85,2,0,0
1827,"No", 1003,370,26273,26370,97,2,7,0
1825,"No", 1010,321,26258,26380,122,2,37,4
1831,"No", 1008,282,26326,26405,79,2,0,0
1823,"No", 1002,65,26209,26408,199,2,52,0
1830,"No", 1008 1007,43,26299,26443,144,4,31,4
1832,"No", 1001,36,26329,26472,143,2,23,4
1834,"No", 1003,285,26370,26479,109,2,15,3
1833,"No", 1009,71,26366,26493,127,2,15,0
1829,"No", 1004,300,26281,26497,216,2,60,7
1837,"No", 1007 1010,218,26443,26543,100,4,6,1
1826,"No", 1006,118,26271,26564,293,6,61,6
1838,"No", 1008,284,26461,26574,113,2,14,0
1839,"No", 1001,29,26472,26589,117,2,17,2
1835,"No", 1005,167,26375,26589,214,2,55,5
1836,"No", 1008 1002 1010,26,26380,26599,219,6,65,1
1840,"No", 1003 1009,112,26479,26639,160,8,12,0
1841,"No", 1004,137,26497,26652,155,2,35,5
1846,"No", 1005 1002,248,26589,26674,85,4,1,0
1842,"No", 1007 1003 1010,302,26512,26675,163,7,44,0
1845,"No", 1001,204,26589,26703,114,6,13,0
1843,"No", 1008 1006,51,26564,26705,141,12,11,1
1847,"No", 1006,104,26606,26722,116,2,13,4
1844,"No", 1007,356,26580,26723,143,8,9,1
1850,"No", 1004 1002,135,26652,26737,85,8,1,0
1849,"No", 1009,377,26639,26738,99,2,12,1
1848,"No", 1005,186,26636,26783,147,6,13,1
1851,"No", 1003 1010,379,26675,26795,120,8,31,4
1853,"No", 1008,367,26705,26796,91,2,2,0
1852,"No", 1001,190,26703,26808,105,2,8,0
1854,"No", 1006,113,26722,26816,94,2,15,0
1855,"No", 1007 1004,202,26723,26843,120,4,8,0
1857,"No", 1005 1009,53,26738,26876,138,4,5,0
1863,"No", 1006,98,26816,26881,65,2,2,1
1860,"No", 1009,130,26794,26881,87,2,2,0
1858,"No", 1003,160,26786,26884,98,6,6,2
1861,"No", 1010,198,26795,26903,108,2,16,0
1856,"No", 1002,279,26737,26904,167,2,26,0
1864,"No", 1004,329,26843,26913,70,2,4,2
1859,"No", 1007,286,26787,26924,137,2,25,1
1862,"No", 1008 1001,325,26796,26928,132,4,5,0
1865,"No", 1008,176,26847,26938,91,2,1,0
1869,"No", 1002,371,26904,26990,86,2,0,0
1871,"No", 1007,21,26924,27005,81,2,10,1
1872,"No", 1001,76,26928,27008,80,2,3,0
1867,"No", 1009,345,26881,27008,127,2,6,2
1868,"No", 1003 1010,316,26884,27025,141,4,10,1
1874,"No", 1003,215,26942,27043,101,4,0,0
1870,"No", 1004,356,26913,27045,132,2,27,0
1875,"No", 1005,125,26976,27047,71,2,1,0
1866,"No", 1006 1005,113,26876,27049,173,4,42,2
1873,"No", 1008,17,26938,27068,130,2,6,1
1876,"No", 1007 1002 1001,341,26990,27079,89,9,21,0
1877,"No", 1010 1009,127,27008,27092,84,4,0,0
1878,"No", 1003,211,27043,27127,84,2,6,0
1880,"No", 1006,10,27049,27135,86,2,2,1
1879,"No", 1005 1004,269,27045,27175,130,12,30,3
1882,"No", 1002 1001,16,27069,27180,111,4,5,0
1883,"No", 1007,14,27083,27184,101,2,2,0
1881,"No", 1008 1009,24,27065,27185,120,4,16,1
1886,"No", 1009,21,27109,27187,78,2,6,0
1887,"No", 1003,176,27127,27219,92,6,4,1
1884,"No", 1010,351,27092,27227,135,2,33,0
1885,"No", 1002,65,27106,27229,123,2,20,0
1889,"No", 1005 1001,34,27175,27246,71,4,8,1
1891,"No", 1008 1009,104,27185,27278,93,4,0,0
1894,"No", 1010,232,27227,27294,67,2,2,1
1888,"No", 1006 1004,126,27135,27305,170,4,23,2
1896,"No", 1008,17,27240,27315,75,2,0,0
1892,"No", 1006,222,27205,27316,111,2,6,0
1890,"No", 1007,71,27184,27323,139,2,8,1
1893,"No", 1003,288,27219,27329,110,2,6,1
1895,"No", 1002,125,27229,27332,103,2,16,1
1898,"No", 1001 1009,265,27246,27363,117,4,6,1
1897,"No", 1005,315,27244,27366,122,6,5,0
1900,"No", 1008 1006,194,27315,27384,69,4,13,1
1902,"No", 1003 1001,64,27329,27415,86,4,14,0
1899,"No", 1004 1010,67,27294,27418,124,4,20,3
1901,"No", 1007,186,27323,27444,121,2,10,2
1904,"No", 1003,141,27375,27467,92,2,2,1
1906,"No", 1006,60,27384,27476,92,2,0,0
1905,"No", 1008,35,27382,27479,97,2,11,1
1903,"No", 1005 1002 1009,306,27332,27481,149,10,6,1
1908,"No", 1004 1001,152,27415,27512,97,3,34,2
1907,"No", 1010 1009,215,27389,27519,130,4,15,0
1910,"No", 1007,86,27444,27564,120,2,0,0
1913,"No", 1008,146,27479,27567,88,2,4,1
1909,"No", 1002,162,27422,27569,147,2,8,0
1912,"No", 1006,50,27476,27576,100,2,3,0
1914,"No", 1005,43,27481,27579,98,2,4,1
1911,"No", 1003 1010,80,27462,27586,124,8,6,2
1915,"No", 1010,25,27485,27614,129,6,7,0
1916,"No", 1004 1001 1009,296,27512,27627,115,16,78,1
1920,"No", 1001,13,27597,27694,97,2,0,0
1919,"No", 1003,35,27586,27695,109,2,5,1
1918,"No", 1006 1005 1002,217,27569,27695,126,6,49,0
1917,"No", 1008 1007,149,27564,27695,131,4,42,1
1924,"No", 1009,379,27627,27727,100,6,3,0
1922,"No", 1010,109,27614,27736,122,2,7,2
1925,"No", 1006 1002,64,27630,27743,113,4,17,1
1923,"No", 1004,99,27625,27763,138,2,5,0
1921,"No", 1007,193,27606,27764,158,2,25,2
1927,"No", 1005,371,27695,27772,77,2,5,1
1928,"No", 1008 1002,288,27695,27776,81,4,4,1
1926,"No", 1003 1001,197,27694,27785,91,4,2,0
1929,"No", 1010 1009,152,27727,27817,90,4,0,0
1931,"No", 1008 1001,124,27751,27834,83,4,2,1
1930,"No", 1006,315,27743,27859,116,2,18,0
1936,"No", 1010,109,27817,27896,79,2,2,1
1932,"No", 1004,367,27763,27902,139,2,32,3
1934,"No", 1002 1009,151,27776,27905,129,4,32,5
1935,"No", 1003 1001,235,27785,27914,129,4,11,0
1933,"No", 1007 1005,306,27764,27925,161,4,18,1
1937,"No", 1007,33,27833,27936,103,2,8,0
1940,"No", 1002,90,27844,27947,103,2,14,2
1938,"No", 1008,281,27834,27964,130,2,27,4
1939,"No", 1003,299,27837,27965,128,2,26,1
1941,"No", 1006 1010,120,27859,27966,107,8,4,0
1943,"No", 1009,35,27905,28012,107,2,9,2
1944,"No", 1005 1001,192,27914,28033,119,4,8,1
1947,"No", 1003,358,27965,28065,100,6,15,1
1942,"No", 1004,32,27902,28065,163,6,25,2
1946,"No", 1008,80,27964,28073,109,6,7,0
1948,"No", 1010,182,27966,28100,134,6,12,2
1945,"No", 1007 1006 1002,172,27936,28110,174,14,30,2
1949,"No", 1002 1001,206,27974,28131,157,4,34,1
1952,"No", 1003,145,28065,28136,71,6,1,0
1953,"No", 1007 1004,45,28065,28144,79,4,6,1
1954,"No", 1008,102,28073,28164,91,2,4,0
1955,"No", 1001,53,28073,28173,100,2,11,2
1951,"No", 1009,75,28055,28190,135,6,18,0
1957,"No", 1006,368,28110,28202,92,2,8,2
1956,"No", 1010,26,28100,28210,110,2,16,0
1950,"No", 1007 1005 1009,225,28012,28218,206,6,30,5
1959,"No", 1004,33,28137,28249,112,2,13,3
1958,"No", 1003 1002,324,28131,28258,127,14,35,2
1960,"No", 1008 1007,307,28144,28283,139,8,10,1
1963,"No", 1007,222,28195,28290,95,2,10,2
1961,"No", 1001,217,28173,28292,119,2,19,2
1966,"No", 1005 1002,211,28218,28301,83,4,6,2
1964,"No", 1006,160,28202,28318,116,2,16,0
1962,"No", 1009,363,28190,28322,132,6,24,0
1965,"No", 1010,244,28210,28337,127,2,14,2
1968,"No", 1005 1003,21,28258,28371,113,4,15,2
1970,"No", 1007 1001,234,28290,28390,100,6,23,3
1969,"No", 1008,86,28283,28396,113,6,5,0
1967,"No", 1004,85,28249,28407,158,2,15,2
1971,"No", 1006 1002 1009,344,28301,28422,121,6,16,0
1972,"No", 1003,207,28323,28432,109,2,0,0
1973,"No", 1002 1010,136,28327,28444,117,4,1,0
1974,"No", 1006 1005,310,28369,28481,112,4,0,0
1975,"No", 1002 1001,332,28386,28512,126,8,37,0
1977,"No", 1007 1006,2,28403,28529,126,4,13,0
1976,"No", 1008,264,28396,28530,134,2,10,0
1978,"No", 1004,12,28407,28542,135,2,26,1
1979,"No", 1009,164,28422,28544,122,2,18,3
1982,"No", 1002,286,28452,28550,98,2,18,1
1983,"No", 1007,149,28470,28571,101,2,6,0
1980,"No", 1003,201,28432,28578,146,6,32,1
1981,"No", 1010,70,28444,28580,136,6,12,0
1985,"No", 1001,206,28512,28589,77,2,12,0
1984,"No", 1005,135,28481,28605,124,2,16,1
1987,"No", 1008,177,28530,28619,89,2,3,0
1986,"No", 1006,136,28529,28620,91,2,17,1
1988,"No", 1004,141,28542,28640,98,2,10,3
1991,"No", 1007,48,28571,28652,81,2,2,1
1992,"No", 1003 1010,347,28578,28674,96,4,19,0
1993,"No", 1001,127,28589,28677,88,2,1,0
1989,"No", 1009,316,28544,28678,134,2,30,2
1990,"No", 1002,142,28550,28701,151,2,11,0
1994,"No", 1005,357,28605,28708,103,2,27,1
1995,"No", 1008 1006,231,28619,28713,94,4,9,3
1996,"No", 1004,248,28640,28743,103,2,6,2
1998,"No", 1010,192,28674,28776,102,6,9,3
1999,"No", 1001,147,28677,28782,105,2,8,1
2000,"No", 1008,87,28678,28788,110,2,2,1
1997,"No", 1007 1003,286,28652,28799,147,4,29,0